1,259,113,3,1,376
2,233,118,2,3,356
3,268,124,3,2,397
4,290,105,3,2,400
5,265,119,5,0,389
6,238,100,5,0,343
7,214,109,5,1,329
8,242,88,5,1,336
9,228,89,4,0,321
10,225,134,0,0,359
11,234,135,2,0,371
12,236,134,5,1,376
13,238,145,2,1,386
14,218,130,4,0,352
15,228,149,5,1,383
16,246,126,1,1,374
17,217,136,3,1,357
18,235,133,3,1,372
19,211,140,5,2,358
20,253,146,3,1,403
21,211,128,1,0,340
22,215,108,5,0,328
23,216,122,2,0,340
24,235,130,2,0,367
25,227,109,3,1,340
26,234,99,2,4,339
27,181,137,4,0,322
28,180,126,1,0,307
29,167,108,0,0,275
30,211,180,8,1,400
31,189,192,3,0,384
32,149,171,2,0,322
33,173,173,2,0,348
34,171,147,2,0,320
35,174,140,4,1,319
36,138,166,6,2,312
37,152,154,1,2,309
38,202,168,5,0,375
39,199,194,2,1,396
40,214,167,7,0,388
41,200,175,2,1,378
42,220,151,1,2,374
43,206,181,2,3,392
44,217,165,4,1,387
45,216,177,5,0,398
46,212,171,3,0,386
47,190,179,2,2,373
48,213,156,3,0,372
49,214,167,3,0,384
50,205,177,4,0,386
51,243,139,2,1,385
52,209,179,3,0,391
53,214,144,6,0,364
54,250,176,9,1,436
55,261,152,1,0,414
56,223,155,2,2,382
57,205,135,2,0,342
58,226,117,6,1,350
59,9,10,0,0,19
60,13,10,0,0,23
61,219,96,5,0,320
62,181,89,1,0,271
63,196,80,3,1,280
64,257,123,3,1,384
65,247,145,4,1,397
66,226,165,2,0,393
67,264,133,1,1,399
68,244,147,4,0,395
69,227,138,2,1,368
70,271,139,4,0,414
71,213,119,2,1,335
72,220,114,2,1,337
73,199,137,2,3,341
74,222,119,2,1,344
75,225,115,2,0,342
76,292,143,1,2,438
77,245,174,6,1,426
78,285,147,4,2,438
79,267,144,5,3,419
80,267,130,3,0,400
81,291,147,3,0,441
82,274,140,5,0,419
83,280,120,3,0,403
84,271,109,3,0,383
85,249,119,3,0,371
86,264,126,5,2,397
87,238,130,2,0,370
88,280,169,5,1,455
89,290,135,4,1,430
90,274,152,4,0,430
91,270,163,3,0,436
92,272,168,3,0,443
93,273,160,5,5,443
94,277,123,6,0,406
95,272,133,2,0,407
96,287,133,3,2,425
97,277,151,4,0,432
98,278,134,5,0,417
99,260,165,7,0,432
100,273,162,2,0,437
101,289,138,3,3,433
102,278,134,2,1,415
103,250,159,1,2,412
104,280,154,9,0,443
105,234,127,4,0,365
106,209,158,4,1,372
107,238,133,9,1,381
108,241,122,5,1,369
109,235,120,1,1,357
110,230,107,5,0,342
111,326,146,5,0,477
112,315,129,5,0,449
113,332,130,3,1,466
114,316,134,5,1,456
115,309,109,5,1,424
116,270,125,6,2,403
117,248,119,9,3,379
118,264,98,3,2,367
119,275,80,2,0,357
120,317,145,3,1,466
121,327,124,4,0,455
122,295,148,7,2,452
123,294,150,4,1,449
124,281,156,8,1,446
125,284,114,6,2,406
126,290,159,4,1,454
127,294,140,2,0,436
128,306,157,0,2,465
129,284,172,4,2,462
130,312,131,4,0,447
131,317,138,6,0,461
132,303,141,6,0,450
133,305,137,2,0,444
134,297,140,3,0,440
135,252,133,7,0,392
136,240,116,4,1,361
137,267,98,1,0,366
138,262,110,2,2,376
139,247,129,2,1,379
140,303,163,2,1,469
141,302,151,4,1,458
142,300,137,4,3,444
143,316,124,2,1,443
144,332,118,0,0,450
145,309,118,5,1,433
146,294,139,3,1,437
147,289,141,7,0,437
148,259,151,2,0,412
149,260,107,3,0,370
150,252,119,2,0,373
151,241,117,2,0,360
152,260,124,4,1,389
153,257,127,5,0,389
154,267,129,2,0,398
155,224,99,0,1,324
156,238,98,4,0,340
157,299,115,5,1,420
158,284,132,6,2,424
159,284,127,10,3,424
160,313,118,10,3,444
161,275,120,4,2,401
162,183,129,1,0,313
163,164,139,2,0,305
164,111,224,5,0,340
165,100,230,7,0,337
166,80,202,1,1,284
167,102,188,4,0,294
168,82,192,1,0,275
169,90,176,3,0,269
170,96,180,2,0,278
171,94,183,2,1,280
172,98,190,2,0,290
173,84,167,3,0,254
174,283,148,2,0,433
175,287,155,3,0,445
176,287,151,5,0,443
177,221,170,2,0,393
178,223,117,8,0,348
179,269,119,4,0,392
180,21,24,3,1,49
181,250,142,5,2,399
182,268,135,5,2,410
183,245,137,3,0,385
184,271,124,7,0,402
185,229,118,5,3,355
186,206,123,5,0,334
187,262,162,8,1,433
188,274,152,7,0,433
189,286,115,3,1,405
190,259,143,6,0,408
191,277,134,6,2,419
192,274,161,4,3,442
193,265,118,9,0,392
194,289,134,8,2,433
195,298,134,9,2,443
196,276,153,7,0,436
197,276,146,3,0,425
198,284,144,2,0,430
199,300,143,3,1,447
200,305,115,4,0,424
201,271,131,5,0,407
202,301,129,3,7,440
203,274,136,3,1,414
204,302,142,3,0,447
205,283,147,4,2,436
206,264,145,2,3,414
207,287,126,5,1,419
208,281,124,3,1,409
209,271,154,4,1,430
210,263,131,6,2,402
211,275,148,5,1,429
212,296,138,4,1,439
213,305,128,3,2,438
214,260,153,3,1,417
215,268,136,5,2,411
216,248,110,8,1,367
217,265,101,3,1,370
218,185,106,5,2,298
219,137,219,3,0,359
220,151,216,5,0,372
221,164,209,7,0,380
222,134,206,5,0,345
223,147,212,2,2,363
224,152,222,5,1,380
225,126,232,4,1,363
226,143,208,2,0,353
227,170,187,5,0,362
228,140,236,1,0,377
229,133,222,5,0,360
230,118,225,4,0,347
231,139,226,0,0,365
232,144,219,4,0,367
233,132,237,5,1,375
234,133,211,5,0,349
235,122,242,4,1,369
236,139,202,3,0,344
237,126,238,2,2,368
238,144,207,6,0,357
239,149,219,0,2,370
240,137,210,3,0,350
241,115,208,5,0,328
242,112,258,6,1,377
243,135,216,2,0,353
244,152,209,2,0,363
245,136,223,2,0,361
246,155,213,4,2,374
247,132,234,4,0,370
248,144,220,1,0,365
249,144,210,2,0,356
250,122,197,5,1,325
251,131,196,4,0,331
252,127,178,5,2,312
253,95,169,1,1,266
254,312,155,3,1,471
255,279,168,5,3,455
256,297,139,4,2,442
257,297,141,1,1,440
258,299,172,3,1,475
259,304,149,2,1,456
260,287,150,5,0,442
261,261,125,3,1,390
262,245,127,3,0,375
263,239,141,2,1,383
264,195,182,6,0,383
265,173,182,3,0,358
266,197,196,1,1,395
267,189,186,5,0,380
268,180,197,3,0,380
269,167,206,3,0,376
270,202,162,4,0,368
271,170,191,7,0,368
272,172,215,4,0,391
273,190,184,3,0,377
274,153,210,4,0,367
275,184,198,1,0,383
276,192,189,4,1,386
277,196,188,3,0,387
278,180,173,1,1,355
279,181,175,4,0,360
280,5,6,1,0,12
281,275,145,2,1,423
282,254,158,2,0,414
283,242,166,5,0,413
284,246,162,3,0,411
285,250,164,4,1,419
286,230,166,5,1,402
287,278,151,1,2,432
288,242,168,5,1,416
289,263,167,1,1,432
290,263,149,5,0,417
291,241,170,3,1,415
292,267,153,0,1,421
293,254,149,4,3,410
294,247,139,3,1,390
295,248,170,3,1,422
296,251,137,2,1,391
297,265,136,4,2,407
298,242,156,2,0,400
299,256,150,3,2,411
300,288,137,4,0,429
301,269,142,4,0,415
302,280,158,1,1,440
303,254,141,4,2,401
304,260,162,3,0,425
305,240,166,5,1,412
306,238,133,2,3,376
307,212,135,2,0,349
308,215,126,1,1,343
309,214,123,3,2,342
310,147,203,4,0,354
311,153,200,0,1,354
312,164,177,2,0,343
313,152,199,3,1,355
314,161,167,0,0,328
315,141,195,6,0,342
316,141,167,0,0,308
317,120,162,1,0,283
318,133,160,2,0,295
319,133,165,4,0,302
320,142,164,1,0,307
321,239,177,1,2,419
322,235,140,2,0,377
323,241,155,0,1,397
324,258,132,3,0,393
325,219,160,3,0,382
326,241,151,2,2,396
327,249,146,3,0,398
328,213,180,5,1,399
329,229,168,1,2,400
330,236,149,5,0,390
331,215,167,4,1,387
332,248,150,3,3,404
333,250,179,4,0,433
334,250,146,4,1,401
335,245,166,1,0,412
336,243,143,0,0,386
337,229,163,4,0,396
338,210,215,2,0,427
339,244,150,3,4,401
340,252,160,2,1,415
341,248,160,0,1,409
342,252,193,3,1,449
343,243,146,4,2,395
344,214,145,3,1,363
345,195,144,3,0,342
346,188,156,0,0,344
347,218,114,5,0,337
348,174,213,1,1,389
349,175,224,5,0,404
350,184,206,2,0,392
351,172,226,4,0,402
352,169,204,1,1,375
353,135,169,6,1,311
354,136,175,2,0,313
355,145,189,3,0,337
356,129,209,3,0,341
357,241,186,7,3,437
358,208,192,0,3,403
359,241,193,1,0,435
360,218,204,2,1,425
361,219,188,5,1,413
362,260,162,3,1,426
363,228,192,1,1,422
364,215,202,1,1,419
365,226,173,4,1,404
366,229,182,2,0,413
367,219,206,5,1,431
368,252,146,2,0,400
369,196,213,2,2,413
370,206,190,2,1,399
371,244,167,5,0,416
372,232,182,2,0,416
373,254,165,4,0,423
374,228,157,4,1,390
375,212,122,3,1,338
376,283,151,2,1,437
377,296,139,2,0,437
378,254,172,2,1,429
379,259,172,0,0,431
380,267,146,2,4,419
381,242,145,3,1,391
382,261,176,3,1,441
383,288,135,4,1,428
384,254,154,1,1,410
385,141,292,3,0,436
386,254,159,6,0,419
387,245,151,2,0,398
388,239,113,1,0,353
389,230,113,6,0,349
390,209,141,1,0,351
391,219,142,2,2,365
392,225,122,4,0,351
393,274,133,7,0,414
394,265,161,5,0,431
395,261,149,6,0,416
396,255,148,0,0,403
397,218,175,3,0,396
398,239,191,5,2,437
399,199,147,0,0,346
400,216,122,2,1,341
401,200,149,2,1,352
402,189,128,7,1,325
403,219,125,5,0,349
404,253,155,2,0,410
405,248,148,5,2,403
406,276,155,1,1,433
407,265,157,3,1,426
408,213,136,5,0,354
409,217,137,0,5,359
410,318,123,6,0,447
411,301,123,2,0,426
412,305,135,5,2,447
413,300,121,6,0,427
414,277,138,2,2,419
415,303,132,3,2,440
416,288,141,5,2,436
417,314,135,5,0,454
418,268,154,4,1,427
419,310,136,3,1,450
420,273,146,7,2,428
421,319,130,7,0,456
422,290,139,7,1,437
423,305,135,5,0,445
424,274,150,6,0,430
425,299,127,7,1,434
426,303,136,2,1,442
427,297,145,2,1,445
428,290,148,2,3,443
429,251,100,4,0,355
430,241,98,2,1,342
431,267,144,5,1,417
432,300,121,6,0,427
433,299,123,3,0,425
434,303,116,4,1,424
435,297,138,4,1,440
436,295,151,2,2,450
437,279,134,2,0,415
438,299,147,2,0,448
439,252,152,7,0,411
440,295,115,1,0,411
441,282,131,4,1,418
442,274,147,4,1,426
443,274,145,8,0,427
444,276,147,3,1,427
445,274,145,8,2,429
446,265,142,4,1,412
447,283,159,1,0,443
448,251,160,3,3,417
449,289,139,5,0,433
450,269,110,2,2,383
451,213,106,10,2,331
452,276,127,4,1,408
453,300,126,1,1,428
454,240,106,4,0,350
455,215,104,7,0,326
456,213,99,2,2,316
457,243,178,6,6,433
458,211,187,8,2,408
459,247,167,2,3,419
460,256,152,7,3,418
461,254,171,4,0,429
462,261,156,6,2,425
463,250,147,8,1,406
464,236,162,13,0,411
465,218,165,8,1,392
466,244,164,6,3,417
467,214,189,5,1,409
468,240,159,6,1,406
469,229,153,5,2,389
470,195,128,7,2,332
471,174,168,4,3,349
472,192,142,7,1,342
473,257,169,4,1,431
474,272,183,3,0,458
475,246,165,11,0,422
476,271,163,5,2,441
477,271,141,11,1,424
478,250,161,6,2,419
479,273,167,7,0,447
480,279,157,6,3,445
481,281,179,3,3,466
482,252,180,5,0,437
483,260,158,10,0,428
484,258,169,7,0,434
485,294,132,3,1,430
486,285,140,7,0,432
487,237,143,6,2,388
488,259,122,2,2,385
489,235,134,1,2,372
490,25,12,0,0,37
491,273,147,5,0,425
492,262,188,3,0,453
493,278,150,5,1,434
494,297,151,6,0,454
495,295,148,5,1,449
496,304,127,4,2,437
497,284,161,9,1,455
498,296,145,6,0,447
499,298,141,4,0,443
500,293,154,7,0,454
501,292,150,3,0,445
502,280,157,4,0,441
503,292,149,4,0,445
504,264,158,4,2,428
505,289,144,4,1,438
506,257,127,5,2,391
507,227,109,1,1,338
508,238,181,1,3,423
509,238,167,2,1,408
510,233,184,2,0,419
511,279,154,4,2,439
512,242,174,3,1,420
513,232,183,1,0,416
514,242,186,3,1,432
515,247,150,3,1,401
516,270,166,3,0,439
517,249,159,3,0,411
518,248,176,1,0,425
519,226,176,2,0,404
520,247,183,2,0,432
521,240,187,3,0,430
522,244,185,3,1,433
523,214,188,3,0,405
524,223,193,2,0,418
525,260,161,3,0,424
526,267,154,3,0,424
527,220,173,5,1,399
528,259,174,5,1,439
529,254,173,2,0,429
530,255,171,4,1,431
531,208,170,0,2,380
532,225,189,9,1,424
533,259,158,2,0,419
534,242,176,1,0,419
535,265,182,2,1,450
536,239,161,1,0,401
537,240,183,0,0,423
538,241,188,3,1,433
539,234,199,4,1,438
540,270,169,2,1,442
541,232,188,4,0,424
542,205,142,4,1,352
543,12,20,2,0,34
544,201,201,2,0,404
545,222,168,3,0,393
546,198,191,4,0,393
547,217,223,5,0,445
548,230,162,5,1,398
549,217,178,10,0,405
550,222,188,3,0,413
551,230,167,2,0,399
552,224,169,3,0,396
553,224,153,5,0,382
554,189,219,2,1,411
555,225,190,2,1,418
556,220,177,6,1,404
557,211,190,1,0,402
558,211,151,0,1,363
559,205,107,1,0,313
560,192,90,2,0,284
561,212,191,2,0,405
562,188,194,7,0,389
563,229,172,5,0,406
564,209,211,1,1,422
565,219,214,3,0,436
566,199,192,0,1,392
567,208,192,5,0,405
568,196,165,3,0,364
569,164,206,2,0,372
570,206,169,4,0,379
571,190,174,1,0,365
572,180,185,3,1,369
573,179,193,1,0,373
574,187,189,2,2,380
575,191,187,2,0,380
576,179,182,1,1,363
577,43,23,1,0,67
578,218,196,3,1,418
579,243,184,3,0,430
580,229,142,0,0,371
581,202,163,1,1,367
582,177,151,4,0,332
583,215,127,2,1,345
584,83,34,1,0,118
585,166,133,1,1,301
586,173,132,2,0,307
587,184,212,4,1,401
588,183,216,3,0,402
589,164,234,3,0,401
590,182,215,1,0,398
591,164,226,3,0,393
592,179,224,4,0,407
593,152,173,1,1,327
594,172,162,0,1,335
595,152,170,2,0,324
596,229,158,0,1,388
597,225,171,3,2,401
598,222,163,3,0,388
599,224,165,5,0,394
600,286,127,0,0,413
601,272,153,1,0,426
602,238,159,3,0,400
603,223,137,4,2,366
604,249,158,3,0,410
605,234,162,3,1,400
606,230,173,3,0,406
607,218,184,3,0,405
608,230,144,7,0,381
609,219,150,6,0,375
610,186,192,4,1,383
611,204,161,2,0,367
612,245,159,3,0,407
613,211,196,3,0,410
614,223,168,0,1,392
615,253,170,4,0,427
616,214,127,2,1,344
617,205,112,2,0,319
618,258,152,5,0,415
619,289,140,1,0,430
620,259,171,1,0,431
621,233,171,2,0,406
622,240,178,5,0,423
623,270,169,3,0,442
624,289,149,2,3,443
625,248,166,4,0,418
626,262,144,4,0,410
627,256,171,4,0,431
628,263,169,2,1,435
629,264,159,2,0,425
630,221,161,3,1,386
631,246,176,2,0,424
632,286,168,0,0,454
633,273,170,4,0,447
634,188,133,2,0,323
635,238,130,4,4,376
636,189,123,3,0,315
637,84,32,0,0,116
638,8,4,0,0,12
639,8,17,0,0,25
640,319,123,3,0,445
641,301,159,4,0,464
642,303,157,8,2,470
643,292,151,4,3,450
644,329,127,2,1,459
645,307,140,8,1,456
646,293,153,6,1,453
647,293,146,0,1,440
648,304,136,3,1,444
649,296,153,5,2,456
650,286,140,4,1,431
651,299,128,5,0,432
652,276,109,2,2,389
653,260,100,5,0,365
654,264,125,4,3,396
655,241,117,1,1,360
656,348,91,3,1,443
657,368,99,1,2,470
658,352,95,0,2,449
659,230,61,2,0,293
660,277,66,1,0,344
661,107,43,1,0,151
662,250,160,6,0,416
663,262,157,4,3,426
664,258,158,2,0,418
665,240,114,1,0,355
666,219,138,3,0,360
667,226,120,5,0,351
668,166,196,4,1,367
669,197,186,6,2,391
670,178,171,1,1,351
671,195,178,2,1,376
672,199,171,5,0,375
673,177,159,6,0,342
674,246,56,3,0,305
675,290,60,3,0,353
676,259,77,2,2,340
677,212,85,0,3,300
678,320,65,1,1,387
679,314,67,5,0,386
680,271,63,4,1,339
681,280,80,2,0,362
682,245,87,1,0,333
683,217,103,1,0,321
684,141,53,1,0,195
685,30,43,1,1,75
686,188,55,3,0,246
687,178,65,2,1,246
688,72,25,0,0,97
689,136,45,0,1,182
690,250,196,2,0,448
691,281,169,7,3,460
692,294,164,4,0,462
693,263,188,4,0,455
694,105,59,1,1,166
695,282,149,4,0,435
696,226,178,2,0,406
697,215,187,3,0,405
698,237,196,3,0,436
699,239,184,5,0,428
700,218,169,3,1,391
701,165,170,2,0,337
702,169,185,2,0,356
703,154,181,3,1,339
704,194,153,3,1,351
705,199,152,2,0,353
706,220,185,3,2,410
707,246,136,4,0,386
708,249,182,4,2,437
709,254,181,1,0,436
710,249,172,0,0,421
711,275,121,1,3,400
712,230,185,3,3,421
713,273,161,5,0,439
714,233,176,4,0,413
715,286,149,1,1,437
716,238,198,2,0,438
717,255,155,6,0,416
718,259,152,3,2,416
719,255,153,3,1,412
720,268,155,1,0,424
721,186,132,4,0,322
722,217,125,1,0,343
723,193,137,3,0,333
724,248,115,2,0,365
725,223,142,2,1,368
726,231,210,3,2,446
727,257,184,1,0,442
728,261,173,5,2,441
729,229,193,4,2,428
730,259,171,6,0,436
731,254,185,2,0,441
732,236,150,2,0,388
733,202,167,6,1,376
734,221,142,5,1,369
735,307,138,4,1,450
736,279,180,2,0,461
737,286,140,3,1,430
738,311,157,8,0,476
739,276,178,1,1,456
740,302,136,6,1,445
741,265,163,6,1,435
742,275,168,3,0,446
743,227,142,3,1,373
744,220,143,3,3,369
745,214,144,3,0,361
746,255,128,0,0,383
747,262,134,3,0,399
748,292,163,2,1,458
749,305,156,2,3,466
750,281,164,5,1,451
751,291,167,3,1,462
752,314,135,6,1,456
753,228,137,5,1,371
754,232,124,5,0,361
755,231,134,3,0,368
756,233,138,7,1,379
757,294,137,4,0,435
758,114,228,2,0,344
759,131,219,3,1,354
760,110,206,6,0,322
761,101,232,3,0,336
762,102,244,1,0,347
763,147,216,4,2,369
764,114,220,3,0,337
765,135,192,2,0,329
766,125,215,1,1,342
767,114,224,5,0,343
768,107,202,3,1,313
769,98,225,2,0,325
770,125,217,1,1,344
771,112,245,3,0,360
772,99,235,2,1,337
773,126,200,4,0,330
774,103,232,2,2,339
775,133,188,2,2,325
776,90,202,2,0,294
777,77,214,2,1,294
778,95,187,2,1,285
779,106,203,1,0,310
780,321,102,5,1,429
781,340,115,4,5,464
782,346,87,3,1,437
783,335,98,2,1,436
784,349,85,0,0,434
785,366,85,3,0,454
786,356,93,4,0,453
787,319,119,3,1,442
788,320,103,3,1,427
789,336,114,4,0,454
790,371,75,3,1,450
791,350,97,1,1,449
792,295,75,1,0,371
793,330,81,2,0,413
794,243,66,2,0,311
795,192,59,1,0,252
796,254,65,2,0,321
797,187,57,0,0,244
798,29,6,0,0,35
799,11,9,3,0,23
800,186,48,1,1,236
801,223,67,3,0,293
802,313,57,3,2,375
803,202,100,2,1,305
804,203,110,1,0,314
805,178,83,2,0,263
806,59,3,0,0,62
807,96,7,0,1,104
808,41,8,0,0,49
809,80,21,5,0,106
810,141,36,0,1,178
811,39,10,0,0,49
812,229,22,1,0,252
813,262,59,6,0,327
814,254,69,1,0,324
815,244,90,1,1,336
816,263,78,1,2,344
817,252,79,5,2,338
818,219,90,4,1,314
819,211,79,2,0,292
820,224,96,1,0,321
821,306,114,0,1,421
822,195,137,3,0,335
823,189,59,2,3,253
824,245,48,0,0,293
825,227,53,4,1,285
826,101,20,1,1,123
827,281,50,2,0,333
828,246,64,0,0,310
829,124,74,0,2,200
830,164,89,4,3,260
831,170,57,3,1,231
832,171,33,3,1,208
833,202,53,1,0,256
834,355,89,1,0,445
835,329,116,10,2,457
836,328,107,3,0,438
837,285,109,3,0,397
838,254,90,1,0,345
839,311,118,2,3,434
840,113,48,2,0,163
841,94,12,2,1,109
842,130,75,2,1,208
843,104,50,1,1,156
844,61,24,1,0,86
845,110,56,0,1,167
846,156,89,1,0,246
847,30,18,6,1,55
848,44,18,1,0,63
849,49,34,1,0,84
850,53,50,1,1,105
851,7,8,2,0,17
852,318,101,2,0,421
853,372,66,1,0,439
854,339,67,4,0,410
855,326,93,1,2,422
856,367,65,2,1,435
857,252,78,4,1,335
858,266,67,2,2,337
859,296,67,1,1,365
860,254,51,3,0,308
861,265,69,0,0,334
862,278,77,6,1,362
863,320,70,4,1,395
864,261,89,1,0,351
865,321,75,1,0,397
866,25,11,1,0,37
867,36,32,2,2,72
868,266,89,2,3,360
869,281,90,3,0,374
870,231,74,3,4,312
871,236,65,4,1,306
872,8,7,0,0,15
873,66,18,1,0,85
874,54,40,5,0,99
875,109,54,0,0,163
876,9,33,0,0,42
877,201,95,4,1,301
878,172,107,2,1,282
879,177,131,0,2,310
880,283,132,6,0,421
881,237,159,5,5,406
882,231,159,1,0,391
883,268,136,2,1,407
884,269,151,7,0,427
885,258,133,3,1,395
886,283,119,6,0,408
887,293,127,4,1,425
888,258,137,7,2,404
889,285,139,1,0,425
890,260,160,3,1,424
891,322,110,7,2,441
892,295,104,4,0,403
893,250,132,6,0,388
894,250,175,0,0,425
895,260,165,1,2,428
896,288,110,6,0,404
897,232,150,3,0,385
898,301,109,3,2,415
899,311,109,1,1,422
900,276,150,3,1,430
901,251,164,3,0,418
902,249,136,5,1,391
903,231,158,1,0,390
904,258,129,3,0,390
905,272,136,7,0,415
906,265,158,6,0,429
907,237,140,4,0,381
908,268,131,0,0,399
909,258,154,2,0,414
910,284,151,2,1,438
911,237,159,1,0,397
912,223,162,3,0,388
913,230,174,1,0,405
914,250,173,4,0,427
915,204,199,1,0,404
916,224,139,4,1,368
917,196,130,7,1,334
918,204,118,5,1,328
919,187,140,2,1,330
920,187,158,1,0,346
921,14,2,1,0,17
922,220,66,2,0,288
923,222,54,1,0,277
924,190,71,2,1,264
925,87,35,0,1,123
926,164,40,2,1,207
927,96,54,2,0,152
928,347,97,4,0,448
929,323,76,3,1,403
930,307,120,3,1,431
931,314,69,1,0,384
932,289,91,2,0,382
933,288,104,3,0,395
934,260,130,5,2,397
935,22,19,0,0,41
936,121,39,2,0,162
937,172,141,4,0,317
938,325,115,1,1,442
939,312,83,4,0,399
940,264,88,3,1,356
941,260,118,6,0,384
942,283,97,4,1,385
943,308,69,4,3,384
944,113,75,0,0,188
945,241,101,0,1,343
946,267,67,1,0,335
947,37,17,0,0,54
948,21,31,2,0,54
949,93,41,1,3,138
950,271,124,1,1,397
951,70,23,0,0,93
952,223,151,3,1,378
953,241,150,3,2,396
954,235,154,4,0,393
955,222,142,2,1,367
956,207,111,6,0,324
957,217,130,7,0,354
958,256,139,3,1,399
959,219,171,1,0,391
960,199,189,9,0,397
961,172,139,0,0,311
962,174,149,4,0,327
963,324,128,3,0,455
964,293,130,2,1,426
965,308,121,3,1,433
966,301,113,5,0,419
967,285,146,6,0,437
968,289,133,5,1,428
969,285,159,2,1,447
970,331,119,5,2,457
971,298,129,9,0,436
972,260,141,3,1,405
973,314,120,1,1,436
974,284,142,1,2,429
975,242,96,2,2,342
976,307,117,2,0,426
977,97,52,10,0,159
978,189,64,3,2,258
979,313,113,4,1,431
980,313,128,3,1,445
981,305,115,6,2,428
982,315,134,2,1,452
983,330,117,3,0,450
984,123,51,3,0,177
985,190,135,4,0,329
986,235,110,4,0,349
987,225,112,2,0,339
988,172,103,2,1,278
989,182,83,3,1,269
990,186,83,3,0,272
991,198,105,0,1,304
992,215,118,3,0,336
993,193,109,2,0,304
994,198,96,3,0,297
995,294,83,2,1,380
996,102,101,3,1,207
997,123,138,3,0,264
998,146,57,2,1,206
999,109,38,2,1,150
1000,64,26,0,0,90
1001,38,26,1,0,65
1002,114,61,0,0,175
1003,79,24,1,1,105
1004,180,70,3,1,254
1005,15,10,0,0,25
1006,219,64,4,2,289
1007,230,89,3,0,322
1008,159,142,7,4,312
1009,143,138,3,1,285
1010,318,117,7,1,443
1011,282,141,0,0,423
1012,313,127,5,1,446
1013,279,133,3,2,417
1014,276,150,2,1,429
1015,272,151,1,1,425
1016,301,130,5,1,437
1017,283,154,4,0,441
1018,293,130,5,1,429
1019,262,153,1,1,417
1020,272,164,2,0,438
1021,286,138,2,1,427
1022,277,149,5,1,432
1023,300,136,6,0,442
1024,295,126,9,0,430
1025,304,132,2,0,438
1026,259,156,5,0,420
1027,295,130,2,1,428
1028,268,157,7,1,433
1029,299,139,4,1,443
1030,291,134,1,2,428
1031,291,150,4,2,447
1032,281,151,8,3,443
1033,269,133,7,1,410
1034,258,147,4,0,409
1035,304,147,4,0,455
1036,313,123,2,1,439
1037,306,145,1,0,452
1038,276,149,2,1,428
1039,287,144,2,0,433
1040,248,104,1,1,354
1041,239,125,4,0,368
1042,239,129,2,0,370
1043,221,111,0,0,332
1044,251,119,2,3,375
1045,44,30,1,3,78
1046,283,145,5,0,433
1047,232,115,4,0,351
1048,266,89,3,0,358
1049,235,109,1,1,346
1050,307,120,4,4,435
1051,327,107,4,4,442
1052,289,151,5,1,446
1053,311,128,1,0,440
1054,308,130,3,3,444
1055,291,133,3,0,427
1056,302,137,3,2,444
1057,300,135,7,1,443
1058,282,142,3,0,427
1059,311,120,4,2,437
1060,297,128,6,0,431
1061,305,136,4,2,447
1062,307,104,4,2,417
1063,292,127,4,2,425
1064,279,159,2,1,441
1065,298,154,3,0,455
1066,302,133,3,1,439
1067,293,137,3,0,433
1068,277,137,4,0,418
1069,256,91,2,0,349
1070,8,0,0,0,8
1071,302,160,8,2,472
1072,289,139,1,1,430
1073,250,175,2,2,429
1074,273,138,8,1,420
1075,276,164,6,0,446
1076,302,153,1,1,457
1077,307,158,3,1,469
1078,298,149,3,0,450
1079,282,155,7,3,447
1080,272,166,0,0,438
1081,255,181,3,1,440
1082,270,169,5,1,445
1083,284,154,3,1,442
1084,300,133,5,0,438
1085,316,137,4,3,460
1086,263,149,4,1,417
1087,276,155,4,1,436
1088,295,142,2,1,440
1089,293,144,2,2,441
1090,275,141,2,1,419
1091,277,142,5,1,425
1092,249,126,2,0,377
1093,240,189,3,3,435
1094,282,147,1,0,430
1095,260,148,3,2,413
1096,268,165,4,1,438
1097,240,162,2,1,405
1098,223,134,3,0,360
1099,233,117,7,0,357
1100,189,164,3,1,357
1101,224,125,3,1,353
1102,271,154,5,0,430
1103,233,195,4,0,432
1104,238,191,3,1,433
1105,266,177,4,0,447
1106,229,187,5,1,422
1107,260,196,6,0,462
1108,245,200,1,0,446
1109,232,218,3,0,453
1110,257,190,3,0,450
1111,195,175,2,1,373
1112,197,164,2,0,363
1113,263,148,4,1,416
1114,191,204,2,1,398
1115,204,224,1,0,429
1116,232,193,1,1,427
1117,235,203,2,1,441
1118,196,216,3,0,415
1119,233,189,4,0,426
1120,205,186,3,2,396
1121,198,213,7,0,418
1122,234,166,3,1,404
1123,176,203,2,0,381
1124,205,188,0,1,394
1125,232,178,4,1,415
1126,226,189,0,0,415
1127,236,203,0,0,439
1128,226,179,2,1,408
1129,196,197,2,1,396
1130,213,212,4,1,430
1131,203,213,4,1,421
1132,182,174,4,0,360
1133,153,98,5,3,259
1134,149,119,5,0,273
1135,208,193,9,1,411
1136,185,187,2,3,377
1137,225,172,3,1,401
1138,210,201,4,0,415
1139,206,182,2,1,391
1140,212,184,3,1,400
1141,208,216,3,3,430
1142,204,209,2,0,415
1143,222,173,3,0,398
1144,223,158,5,1,387
1145,200,177,2,1,380
1146,230,175,4,2,411
1147,208,176,2,0,386
1148,214,168,4,0,386
1149,205,207,5,0,417
1150,232,151,2,0,385
1151,217,180,0,0,397
1152,222,190,1,0,413
1153,210,176,1,0,387
1154,236,184,1,0,421
1155,209,151,1,0,361
1156,120,219,1,1,341
1157,126,246,1,0,373
1158,160,211,2,1,374
1159,112,234,1,1,348
1160,110,226,2,0,338
1161,131,232,4,0,367
1162,98,203,1,0,302
1163,109,194,1,0,304
1164,101,199,4,0,304
1165,138,193,3,1,335
1166,335,113,1,1,450
1167,330,138,4,0,472
1168,324,139,6,0,469
1169,304,129,5,0,438
1170,312,133,4,1,450
1171,290,139,3,0,432
1172,283,149,6,2,440
1173,302,150,7,1,460
1174,311,143,4,0,458
1175,305,138,2,4,449
1176,294,137,3,0,434
1177,303,113,2,0,418
1178,302,142,7,1,452
1179,325,124,5,0,454
1180,268,110,1,0,379
1181,298,123,2,1,424
1182,202,111,2,0,315
1183,228,118,1,1,348
1184,219,117,2,1,339
1185,225,88,2,0,315
1186,92,62,2,2,158
1187,303,149,3,2,457
1188,273,138,3,1,415
1189,304,131,5,0,440
1190,255,177,4,2,438
1191,258,168,5,0,431
1192,302,119,4,1,426
1193,247,171,5,2,425
1194,272,142,5,1,420
1195,304,132,7,1,444
1196,220,126,2,1,349
1197,263,108,1,1,373
1198,255,120,3,0,378
1199,223,111,4,0,338
1200,238,114,5,0,357
1201,318,111,11,0,440
1202,271,153,4,0,428
1203,234,141,3,0,378
1204,172,111,1,1,285
1205,169,118,2,0,289
1206,212,150,1,1,364
1207,290,155,2,0,447
1208,295,140,2,1,438
1209,256,155,4,2,417
1210,283,143,9,2,437
1211,286,151,6,0,443
1212,272,158,5,0,435
1213,235,133,3,0,371
1214,230,105,4,2,341
1215,255,122,0,0,377
1216,141,89,1,0,231
1217,122,84,0,3,209
1218,304,122,1,0,427
1219,280,143,3,0,426
1220,293,139,9,1,442
1221,271,134,5,1,411
1222,321,120,3,1,445
1223,303,147,6,1,457
1224,240,111,7,0,358
1225,254,101,3,1,359
1226,257,131,1,0,389
1227,267,129,2,0,398
1228,240,105,1,0,346
1229,226,122,3,1,352
1230,222,191,1,0,414
1231,239,178,2,1,420
1232,218,160,2,0,380
1233,242,186,2,1,431
1234,272,141,3,0,416
1235,226,191,2,0,419
1236,243,157,4,0,404
1237,208,191,8,0,407
1238,231,151,1,0,383
1239,243,165,6,0,414
1240,229,175,6,0,410
1241,216,181,4,1,402
1242,243,171,1,2,417
1243,228,183,4,1,416
1244,227,166,4,0,397
1245,245,152,2,0,399
1246,227,152,4,1,384
1247,237,161,4,0,402
1248,269,165,0,0,434
1249,240,164,4,0,408
1250,240,151,5,1,397
1251,223,175,3,0,401
1252,244,179,1,0,424
1253,262,150,5,2,419
1254,254,177,3,0,434
1255,234,178,5,0,417
1256,215,181,1,1,398
1257,243,169,5,1,418
1258,185,140,4,0,329
1259,202,129,4,0,335
1260,198,133,3,0,334
1261,209,131,0,0,340
1262,210,122,1,1,334
1263,143,111,2,0,256
1264,190,193,4,0,387
1265,174,210,5,2,391
1266,193,205,2,0,400
1267,196,204,2,1,403
1268,177,189,5,2,373
1269,196,175,3,0,374
1270,187,205,3,0,395
1271,189,167,5,1,362
1272,178,206,3,0,387
1273,184,224,2,0,410
1274,158,183,4,1,346
1275,129,207,2,0,338
1276,170,158,2,0,330
1277,179,157,2,1,339
1278,190,184,2,1,377
1279,208,178,2,2,390
1280,174,214,6,2,396
1281,141,173,4,0,318
1282,160,152,3,0,315
1283,135,172,4,1,312
1284,154,176,4,1,335
1285,155,157,5,0,317
1286,211,200,2,0,413
1287,221,174,4,1,400
1288,212,165,5,0,382
1289,201,190,4,1,396
1290,207,172,3,2,384
1291,207,184,2,0,393
1292,185,210,2,1,398
1293,193,186,1,1,381
1294,146,161,2,1,310
1295,150,218,1,2,371
1296,148,225,1,1,375
1297,158,198,4,1,361
1298,181,196,4,2,383
1299,153,199,0,0,352
1300,162,201,3,1,367
1301,152,220,4,0,376
1302,145,232,7,1,385
1303,170,190,3,0,363
1304,156,209,1,1,367
1305,140,227,5,0,372
1306,173,196,4,0,373
1307,153,162,1,0,316
1308,141,183,1,0,325
1309,133,184,3,0,320
1310,146,178,3,1,328
1311,155,189,4,0,348
1312,151,192,4,0,347
1313,125,195,4,0,324
1314,114,151,0,0,265
1315,100,183,1,0,284
1316,115,177,3,1,296
1317,89,177,3,0,269
1318,318,152,2,0,472
1319,282,164,6,1,453
1320,318,155,2,2,477
1321,285,166,6,0,457
1322,253,172,5,2,432
1323,304,155,2,0,461
1324,308,153,1,1,463
1325,286,154,6,0,446
1326,302,160,5,0,467
1327,306,139,4,0,449
1328,288,171,4,0,463
1329,319,152,3,0,474
1330,301,157,1,2,461
1331,285,158,4,1,448
1332,295,142,6,1,444
1333,302,141,6,0,449
1334,227,155,3,0,385
1335,257,124,3,2,386
1336,247,129,8,3,387
1337,250,134,2,1,387
1338,264,129,1,1,395
1339,293,177,2,1,473
1340,319,143,6,1,469
1341,310,164,2,0,476
1342,295,160,6,0,461
1343,260,190,3,0,453
1344,289,167,2,1,459
1345,288,163,1,1,453
1346,278,163,10,1,452
1347,313,142,2,0,457
1348,286,152,5,2,445
1349,350,115,4,1,470
1350,276,181,4,1,462
1351,285,128,3,1,417
1352,269,172,1,2,444
1353,168,130,4,2,304
1354,196,98,2,0,296
1355,257,187,1,0,445
1356,270,179,4,1,454
1357,254,200,2,2,458
1358,256,180,3,1,440
1359,259,175,5,1,440
1360,248,149,2,0,399
1361,278,173,4,1,456
1362,238,201,3,0,442
1363,270,177,4,0,451
1364,255,166,3,1,425
1365,283,155,4,1,443
1366,246,170,5,1,422
1367,243,170,5,0,418
1368,200,149,5,0,354
1369,211,139,2,0,352
1370,207,153,5,0,365
1371,228,137,1,1,367
1372,296,169,2,1,468
1373,280,175,1,0,456
1374,292,170,3,2,467
1375,274,181,4,1,460
1376,324,147,4,2,477
1377,284,167,3,1,455
1378,302,167,5,0,474
1379,313,154,2,1,470
1380,270,181,6,1,458
1381,268,181,5,1,455
1382,273,183,7,2,465
1383,318,151,6,0,475
1384,312,160,3,0,475
1385,300,147,4,0,451
1386,283,177,5,0,465
1387,271,182,2,0,455
1388,303,176,7,1,487
1389,255,186,2,1,444
1390,295,152,5,0,452
1391,277,173,9,0,459
1392,308,158,4,1,471
1393,289,164,4,0,457
1394,281,165,0,0,446
1395,304,133,2,0,439
1396,265,189,4,2,460
1397,287,154,1,1,443
1398,298,152,3,0,453
1399,308,142,3,2,455
1400,225,180,2,0,407
1401,229,177,3,0,409
1402,261,128,1,1,391
1403,239,151,4,0,394
1404,246,141,2,1,390
1405,230,158,2,0,390
1406,192,153,1,1,347
1407,211,122,4,0,337
1408,136,81,1,0,218
1409,94,79,1,1,175
1410,335,100,3,2,440
1411,375,85,1,0,461
1412,340,107,5,0,452
1413,337,81,8,1,427
1414,327,92,3,0,422
1415,304,88,3,1,396
1416,302,81,2,1,386
1417,301,65,6,0,372
1418,259,55,0,0,314
1419,306,89,1,3,399
1420,213,86,1,1,301
1421,264,79,4,2,349
1422,257,81,2,0,340
1423,291,78,3,0,372
1424,23,2,0,0,25
1425,252,69,2,1,324
1426,63,17,1,0,81
1427,24,7,0,1,32
1428,217,68,2,2,289
1429,196,61,3,0,260
1430,171,43,2,0,216
1431,315,116,4,1,436
1432,286,109,5,2,402
1433,232,106,2,0,340
1434,231,109,3,1,344
1435,243,108,5,0,356
1436,102,53,1,2,158
1437,115,93,2,1,211
1438,172,78,2,0,252
1439,233,40,5,1,279
1440,184,65,1,1,251
1441,83,19,0,0,102
1442,53,19,0,0,72
1443,129,52,2,0,183
1444,118,63,2,0,183
1445,133,68,2,1,204
1446,125,44,2,0,171
1447,59,65,2,1,127
1448,19,12,0,0,31
1449,25,13,1,0,39
1450,48,16,0,0,64
1451,100,18,0,0,118
1452,91,33,1,0,125
1453,311,130,3,1,445
1454,305,122,0,0,427
1456,315,132,2,0,449
1455,314,114,2,1,431
1457,334,114,3,0,451
1458,290,130,2,2,424
1459,313,131,3,1,448
1460,311,124,3,0,438
1461,298,128,4,1,431
1462,327,110,4,1,442
1463,323,100,5,0,428
1464,293,132,5,0,430
1465,275,147,3,1,426
1466,284,129,5,2,420
1467,302,131,7,0,440
1468,318,102,3,0,423
1469,291,140,5,2,438
1470,315,115,4,1,435
1471,303,134,5,1,443
1472,312,128,3,0,443
1473,322,116,4,1,443
1474,321,134,5,1,461
1475,316,121,1,0,438
1476,303,113,3,0,419
1477,313,111,1,0,425
1478,263,115,8,0,386
1479,297,140,1,0,438
1480,294,138,2,2,436
1481,303,140,3,0,446
1482,284,134,4,1,423
1483,283,135,4,2,424
1484,291,137,8,0,436
1485,288,147,1,0,436
1486,239,128,2,0,369
1487,250,134,2,1,387
1488,250,118,4,0,372
1489,274,124,3,0,401
1490,213,187,0,1,401
1491,220,145,5,0,370
1492,225,153,6,0,384
1493,222,164,1,0,387
1494,213,154,3,1,371
1495,210,150,5,1,366
1496,218,179,2,0,399
1497,217,156,3,0,376
1498,228,135,3,0,366
1499,211,165,4,0,380
1500,205,128,4,0,337
1501,178,126,1,0,305
1502,197,141,3,0,341
1503,313,107,1,2,423
1504,312,127,4,0,443
1505,318,107,4,2,431
1506,359,110,3,2,474
1507,296,129,4,0,429
1508,329,130,3,1,463
1509,311,143,3,1,458
1510,346,115,5,2,468
1511,320,117,4,1,442
1512,316,134,9,0,459
1513,320,117,3,6,446
1514,260,104,7,1,372
1515,271,92,3,2,368
1516,232,116,4,1,353
1517,292,109,1,1,403
1518,151,212,8,1,372
1519,151,209,2,2,364
1520,141,222,4,0,367
1521,129,236,1,1,367
1522,130,214,2,0,346
1523,154,210,0,0,364
1524,130,228,2,1,361
1525,130,238,1,1,370
1526,147,229,3,0,379
1527,145,243,3,2,393
1528,150,210,4,0,364
1529,121,181,5,1,308
1530,165,173,1,0,339
1531,227,183,1,1,412
1532,273,169,7,0,449
1533,244,177,3,0,424
1534,255,172,5,1,433
1535,246,179,5,2,432
1536,262,166,1,0,429
1537,224,149,2,2,377
1538,297,152,2,2,453
1539,296,128,4,0,428
1540,254,183,3,2,442
1541,267,178,3,1,449
1542,265,157,2,0,424
1543,277,156,3,0,436
1544,303,149,1,0,453
1545,278,171,3,0,452
1546,255,123,3,0,381
1547,240,118,6,3,367
1548,252,115,4,1,372
1549,339,116,3,2,460
1550,335,111,1,2,449
1551,314,137,2,0,453
1552,326,131,2,2,461
1553,346,115,2,1,464
1554,320,126,2,1,449
1555,359,121,1,0,481
1556,342,119,2,1,464
1557,331,119,2,0,452
1558,336,121,8,0,465
1559,334,116,4,1,455
1560,333,114,3,1,451
1561,327,133,1,1,462
1562,305,145,7,1,458
1563,321,131,5,1,458
1564,316,149,9,0,474
1565,319,135,4,1,459
1566,308,117,3,1,429
1567,314,119,2,0,435
1568,312,123,7,1,443
1569,325,117,5,0,447
1570,343,129,3,2,477
1571,325,139,5,0,469
1572,316,125,4,1,446
1573,331,105,4,2,442
1574,285,150,4,0,439
1575,338,128,3,0,469
1576,326,135,1,0,462
1577,307,133,6,0,446
1578,311,131,9,0,451
1579,338,115,5,0,458
1580,333,113,5,0,451
1581,338,102,6,1,447
1582,316,104,3,0,423
1583,299,114,5,1,419
1584,291,115,4,1,411
1585,282,90,5,2,379
1586,289,98,4,0,391
1587,7,5,1,1,14
1588,271,182,2,1,456
1589,267,190,5,1,463
1590,259,174,1,1,435
1591,255,190,6,1,452
1592,287,175,1,1,464
1593,234,134,3,0,371
1594,300,145,0,0,445
1595,261,150,6,1,418
1596,285,128,8,1,422
1597,274,168,5,1,448
1598,193,156,2,0,351
1599,199,167,1,1,368
1600,202,161,5,0,368
1601,198,115,5,1,319
1602,314,154,6,0,474
1603,254,167,3,1,425
1604,258,166,2,2,428
1605,264,169,2,0,435
1606,275,160,9,1,445
1607,276,149,4,3,432
1608,261,149,2,1,413
1609,276,167,1,0,444
1610,265,165,4,1,435
1611,257,171,3,0,431
1612,273,161,4,0,438
1613,244,162,6,0,412
1614,291,154,5,1,451
1615,270,147,2,0,419
1616,282,168,1,1,452
1617,271,153,4,0,428
1618,298,155,4,0,457
1619,233,121,5,0,359
1620,203,211,0,1,415
1621,174,189,0,0,363
1622,180,189,2,0,371
1623,183,172,0,0,355
1624,198,194,2,1,395
1625,177,200,5,0,382
1626,285,100,8,1,394
1627,306,108,4,0,418
1628,337,99,6,2,444
1629,317,91,8,0,416
1630,297,124,2,1,424
1631,302,112,7,2,423
1632,271,122,7,2,402
1633,305,93,5,2,405
1634,313,105,5,0,423
1635,321,95,5,1,422
1636,320,110,3,2,435
1637,319,93,4,1,417
1638,333,89,4,0,426
1639,300,119,7,1,427
1640,304,124,7,2,437
1641,271,101,3,0,375
1642,319,121,6,0,446
1643,325,117,1,1,444
1644,327,103,4,2,436
1645,320,119,3,1,443
1646,345,115,1,0,461
1647,328,111,5,1,445
1648,348,105,1,2,456
1649,342,116,4,1,463
1650,329,129,1,2,461
1651,298,116,2,0,416
1652,335,110,3,0,448
1653,357,104,7,0,468
1654,320,111,4,0,435
1655,318,123,2,0,443
1656,279,114,2,0,395
1657,260,114,1,0,375
1658,284,81,2,1,368
1659,268,104,3,1,376
1660,298,89,3,0,390
1661,307,86,2,0,395
1662,32,13,2,1,48
1663,360,111,3,1,475
1664,364,116,3,0,483
1665,340,124,6,0,470
1666,368,106,4,2,480
1667,319,118,5,0,442
1668,335,125,4,1,465
1669,354,114,2,0,470
1670,338,116,7,1,462
1671,347,117,2,1,467
1672,293,92,2,3,390
1673,295,94,3,0,392
1674,286,99,1,1,387
1675,271,114,2,0,387
1676,307,107,7,0,421
1677,275,98,5,0,378
1678,361,111,6,0,478
1679,336,112,2,1,451
1680,346,126,1,1,474
1681,331,138,7,0,476
1682,336,124,6,0,466
1683,322,101,4,0,427
1684,337,108,1,1,447
1685,363,100,4,0,467
1686,289,79,1,1,370
1687,292,93,4,1,390
1688,311,101,6,2,420
1689,310,161,3,1,475
1690,289,136,5,1,431
1691,304,132,5,1,442
1692,310,141,2,3,456
1693,316,129,1,0,446
1694,286,133,4,3,426
1695,288,117,1,1,407
1696,263,159,5,1,428
1697,295,131,2,0,428
1698,279,152,2,1,434
1699,304,102,5,0,411
1700,161,100,2,1,264
1701,200,90,0,1,291
1702,155,72,2,0,229
1703,286,75,3,0,364
1704,190,82,1,0,273
1705,166,91,3,0,260
1706,68,12,0,2,82
1707,48,3,0,0,51
1708,87,24,1,0,112
1709,24,18,3,0,45
1710,76,56,2,1,135
1711,58,18,0,2,78
1712,41,55,1,0,97
1713,194,78,0,0,272
1714,108,78,4,0,190
1715,38,13,0,0,51
1716,293,88,1,1,383
1717,347,72,5,1,425
1718,353,77,5,0,435
1719,283,59,1,0,343
1720,258,68,4,2,332
1721,293,42,3,4,342
1722,346,54,1,1,402
1723,22,6,0,0,28
1724,143,43,3,0,189
1725,267,64,4,3,338
1726,88,27,0,1,116
1727,193,30,2,2,227
1728,113,34,2,1,150
1729,67,29,0,0,96
1730,333,110,5,2,450
1731,271,163,4,0,438
1732,312,121,4,0,437
1733,306,124,5,1,436
1734,303,146,3,0,452
1735,302,135,5,1,443
1736,302,129,5,0,436
1737,282,136,5,0,423
1738,292,129,4,1,426
1739,309,135,0,1,445
1740,251,124,4,1,380
1741,291,150,3,0,444
1742,308,125,3,0,436
1743,255,148,4,1,408
1744,294,137,4,0,435
1745,324,116,2,2,444
1746,315,125,3,2,445
1747,281,146,5,1,433
1748,236,123,3,1,363
1749,261,107,3,0,371
1750,361,105,4,0,470
1751,335,135,4,0,474
1752,345,115,3,0,463
1753,277,103,3,1,384
1754,283,87,4,1,375
1755,309,98,0,1,408
1756,231,96,1,1,329
1757,301,142,5,1,449
1758,313,151,5,3,472
1759,243,126,9,1,379
1760,232,148,3,0,383
1761,267,113,4,2,386
1762,253,112,4,3,372
1763,248,128,3,0,379
1764,301,132,4,0,437
1765,286,132,4,0,422
1766,308,122,2,0,432
1767,298,135,4,0,437
1768,290,142,8,0,440
1769,338,111,8,0,457
1770,242,104,5,3,354
1771,254,120,4,1,379
1772,287,99,4,2,392
1773,20,5,0,0,25
1774,304,145,3,2,454
1775,287,145,9,0,441
1776,274,154,7,1,436
1777,280,162,5,1,448
1778,264,158,9,1,432
1779,256,147,2,1,406
1780,261,163,2,0,426
1781,259,168,2,0,429
1782,286,153,4,1,444
1783,253,158,4,1,416
1784,284,151,5,1,441
1785,256,168,7,0,431
1786,281,152,6,1,440
1787,267,151,4,1,423
1788,250,168,1,0,419
1789,277,119,4,2,402
1790,280,187,13,0,480
1791,292,177,10,0,479
1792,286,169,9,5,469
1793,270,185,9,1,465
1794,290,164,3,0,457
1795,281,185,4,2,472
1796,276,162,3,3,444
1797,240,144,8,0,392
1798,273,140,3,0,416
1799,267,146,6,0,419
1800,276,136,6,1,419
1801,246,151,1,0,398
1802,274,138,3,0,415
1803,251,147,1,1,400
1804,257,145,5,2,409
1805,267,132,0,1,400
1806,135,236,3,1,375
1807,144,203,4,0,351
1808,141,205,5,1,352
1809,142,209,3,1,355
1810,141,197,2,1,341
1811,144,222,5,1,372
1812,112,182,3,0,297
1813,119,184,2,2,307
1814,107,180,3,0,290
1815,149,138,2,1,290
1816,266,128,3,0,397
1817,270,144,2,0,416
1818,258,131,0,0,389
1819,304,119,6,0,429
1820,231,132,2,3,368
1821,254,138,3,1,396
1822,260,134,9,1,404
1823,248,140,6,2,396
1824,251,131,3,0,385
1825,221,120,3,0,344
1826,241,111,1,0,353
1827,193,103,0,0,296
1828,190,91,2,1,284
1829,240,108,5,1,354
1830,240,117,3,3,363
1831,113,93,0,0,206
1832,79,164,3,0,246
1833,72,136,7,0,215
1834,290,133,4,1,428
1835,283,143,1,0,427
1836,265,104,3,1,373
1837,107,57,0,1,165
1838,235,128,5,1,369
1839,232,129,5,2,368
1840,233,65,5,1,304
1841,184,70,4,2,260
1842,69,31,1,0,101
1843,85,33,0,1,119
1844,54,40,2,0,96
1845,104,161,1,0,266
1846,88,174,3,0,265
1847,92,188,1,0,281
1848,223,105,1,2,331
1849,224,109,5,0,338
1850,209,99,5,0,313
1851,257,129,0,3,389
1852,211,150,3,4,368
1853,201,127,5,1,334
1854,186,129,3,1,319
1855,177,154,5,0,336
1856,194,138,2,0,334
1857,225,148,2,0,375
1858,215,134,2,0,351
1859,116,112,2,1,231
1860,125,99,4,1,229
1861,202,145,3,2,352
1862,183,149,9,2,343
1863,190,135,4,2,331
1864,189,156,4,4,353
1865,176,148,3,0,327
1866,218,135,5,1,359
1867,164,136,3,3,306
1868,49,124,1,1,175
1869,159,169,5,2,335
1870,141,169,4,1,315
1871,93,151,2,0,246
1872,78,119,0,0,197
1873,117,222,9,2,350
1874,110,240,2,2,354
1875,107,224,2,0,333
1876,108,249,6,0,363
1877,295,138,7,0,440
1878,281,134,5,3,423
1879,284,159,3,3,449
1880,289,112,11,1,413
1881,250,114,1,0,365
1882,261,142,5,1,409
1883,277,131,3,1,412
1884,257,129,5,0,391
1885,272,164,9,2,447
1886,225,123,6,0,354
1887,204,133,9,3,349
1888,230,179,2,0,411
1889,253,146,6,0,405
1890,245,152,4,0,401
1891,239,165,6,4,414
1892,232,150,4,1,387
1893,101,138,3,0,242
1894,86,140,3,2,231
1895,181,110,2,0,293
1896,180,85,5,0,270
1897,173,106,7,1,287
1898,275,129,2,2,408
1899,229,148,8,2,387
1900,150,143,4,2,299
1901,165,154,5,1,325
1902,110,87,8,3,208
1903,127,71,1,1,200
1904,58,39,1,2,100
1905,140,142,2,0,284
1906,159,88,4,2,253
1907,243,170,0,1,414
1908,233,155,1,0,389
1909,203,173,5,0,381
1910,250,145,3,4,402
1911,235,138,5,0,378
1912,232,139,3,1,375
1913,156,102,2,3,263
1914,115,107,5,4,231
1915,190,215,5,1,411
1916,191,208,4,1,404
1917,173,168,5,0,346
1918,198,159,5,0,362
1919,140,207,4,2,353
1920,111,259,6,5,381
1921,179,171,7,3,360
1922,159,172,3,0,334
1923,253,148,3,0,404
1924,265,145,4,0,414
1925,241,166,4,1,412
1926,251,139,4,2,396
1927,227,207,2,2,438
1928,200,174,2,2,378
1929,229,152,1,1,383
1930,245,164,6,1,416
1931,245,158,5,2,410
1932,227,168,2,2,399
1933,179,160,3,1,343
1934,199,137,5,1,342
1935,192,120,6,2,320
1936,185,211,4,4,404
1937,160,206,3,1,370
1938,185,208,2,0,395
1939,178,183,6,0,367
1940,171,188,2,1,362
1941,119,216,4,1,340
1942,147,169,6,0,322
1943,109,165,7,0,281
1944,43,51,2,0,96
1945,36,64,3,0,103
1946,55,83,0,1,139
1947,34,20,0,1,55
1948,153,187,7,1,348
1949,145,218,8,0,371
1950,134,193,4,1,332
1951,233,155,1,4,393
1952,233,190,4,1,428
1953,214,193,4,0,411
1954,167,162,2,2,333
1955,195,143,4,1,343
1956,150,136,0,1,287
1957,176,141,3,0,320
1958,195,133,1,2,331
1959,56,28,0,0,84
1960,185,103,0,1,289
1961,176,124,3,1,304
1962,191,105,1,2,299
1963,201,25,2,1,229
1964,213,57,2,0,272
1965,176,73,7,1,257
1966,174,26,0,0,200
1967,110,48,2,0,160
1968,192,103,2,1,298
1969,162,108,0,1,271
1970,138,51,3,1,193
1971,98,46,1,0,145
1972,78,41,1,1,121
1973,49,5,1,0,55
1974,87,46,2,2,137
1975,128,34,2,2,166
1976,99,185,5,0,289
1977,97,179,1,0,277
1978,86,159,3,1,249
1979,155,155,3,2,315
1980,114,154,2,1,271
1981,139,138,1,2,280
1982,94,173,4,1,272
1983,59,153,1,1,214
1984,97,217,2,2,318
1985,80,258,5,0,343
1986,67,116,0,0,183
1987,56,94,1,0,151
1988,55,131,5,1,192
1989,36,137,2,1,176
1990,51,72,3,0,126
1991,91,134,1,2,228
1992,75,135,0,2,212
1993,105,158,8,1,272
1994,138,159,2,2,301
1995,123,183,3,0,309
1996,154,195,7,1,357
1997,126,216,11,0,353
1998,137,97,1,0,235
1999,87,49,0,0,136
2000,54,83,0,1,138
2001,105,192,4,0,301
2002,118,208,1,1,328
2003,92,164,2,0,258
2004,73,61,4,0,138
2005,126,138,1,0,265
2006,116,156,4,1,277
2007,119,124,4,1,248
2008,123,129,2,0,254
2009,199,127,8,9,343
2010,103,64,1,3,171
2011,13,39,0,0,52
2012,99,59,2,0,160
2013,110,167,4,1,282
2014,118,151,0,1,270
2015,75,75,1,0,151
2016,61,88,1,0,150
2017,26,43,0,0,69
2018,90,43,3,0,136
2019,113,263,4,0,380
2020,96,216,7,1,320
2021,61,194,7,2,264
2022,75,207,3,3,288
2023,95,212,1,2,310
2024,152,111,2,0,265
2025,69,129,4,1,203
2026,113,99,5,3,220
2027,171,191,2,1,365
2028,130,199,7,0,336
2029,120,195,3,4,322
2030,125,114,2,2,243
2031,118,121,1,1,241
2032,138,177,5,0,320
2033,124,184,6,2,316
2034,203,145,2,1,351
2035,89,64,0,1,154
2036,117,71,2,0,190
2037,108,77,2,0,187
2038,15,15,0,0,30
2039,108,81,1,1,191
2040,146,107,2,0,255
2041,125,133,0,0,258
2042,97,54,1,3,155
2043,38,51,0,0,89
2044,49,35,0,0,84
2045,137,136,2,0,275
2046,49,63,1,0,113
2047,45,80,0,0,125
2048,200,135,3,1,339
2049,158,133,4,1,296
2050,165,141,5,0,311
2051,51,31,1,0,83
2052,88,68,2,1,159
2053,89,76,0,0,165
2054,89,20,0,0,109
2055,114,76,0,2,192
2056,97,22,1,0,120
2057,61,64,1,0,126
2058,228,119,5,2,354
2059,50,21,0,0,71
2060,23,13,0,0,36
2061,75,92,5,1,173
2062,55,68,2,2,127
2063,131,103,2,0,236
2064,77,82,2,0,161
2065,120,132,7,0,259
2066,118,144,5,0,267
2067,318,96,1,3,418
2068,268,110,3,2,383
2069,276,74,2,0,352
2070,280,49,2,0,331
2071,264,65,3,0,332
2072,276,41,3,0,320
2073,160,85,1,0,246
2074,170,74,0,0,244
2075,143,36,0,0,179
2076,46,28,0,0,74
2077,191,43,1,1,236
2078,187,48,1,1,237
2079,170,44,2,2,218
2080,149,19,1,0,169
2081,25,42,0,1,68
2082,242,60,3,0,305
2083,218,49,0,0,267
2084,58,28,7,1,94
2085,97,37,0,1,135
2086,260,42,7,2,311
2087,243,45,6,2,296
2088,178,58,0,0,236
2089,80,31,0,0,111
2090,38,5,0,0,43
2091,316,71,1,0,388
2092,158,39,0,1,198
2093,298,134,2,1,435
2094,324,108,6,0,438
2095,307,113,3,0,423
2096,311,138,5,0,454
2097,271,135,4,0,410
2098,295,122,8,1,426
2099,282,120,4,0,406
2100,286,130,3,1,420
2101,296,125,6,3,430
2102,304,113,1,1,419
2103,265,110,5,4,384
2104,301,96,2,0,399
2105,302,142,1,0,445
2106,280,168,7,2,457
2107,263,153,2,0,418
2108,245,186,5,0,436
2109,287,144,8,1,440
2110,272,157,5,1,435
2111,296,135,2,0,433
2112,297,168,5,0,470
2113,262,157,2,0,421
2114,297,153,7,0,457
2115,278,150,1,0,429
2116,311,127,1,1,440
2117,271,121,5,0,397
2118,259,108,3,1,371
2119,256,114,3,1,374
2120,233,128,1,2,364
2121,284,106,2,0,392
2122,264,118,4,0,386
2123,276,149,1,3,429
2124,261,150,3,1,415
2125,253,155,1,2,411
2126,270,151,6,1,428
2127,229,178,7,0,414
2128,231,156,5,1,393
2129,262,173,6,1,442
2130,275,155,3,0,433
2131,246,153,4,1,404
2132,264,146,4,0,414
2133,240,168,4,0,412
2134,204,145,2,0,351
2135,215,136,3,0,354
2136,223,133,1,0,357
2137,247,159,0,0,406
2138,228,153,7,0,388
2139,206,192,4,0,402
2140,188,185,8,1,382
2141,193,171,4,1,369
2142,207,191,2,1,401
2143,200,169,3,1,373
2144,216,181,2,0,399
2145,230,165,3,0,398
2146,194,179,3,0,376
2147,49,13,1,3,66
2148,261,168,2,0,431
2149,237,122,2,0,361
2150,271,134,1,1,407
2151,308,136,2,2,448
2152,308,151,5,0,464
2153,282,120,7,2,411
2154,292,144,2,0,438
2155,269,144,2,0,415
2156,249,162,3,0,414
2157,265,149,1,0,415
2158,257,141,7,1,406
2159,263,143,1,0,407
2160,266,165,4,0,435
2161,297,117,5,0,419
2162,264,143,4,0,411
2163,217,195,5,0,417
2164,222,170,7,1,400
2165,218,167,4,0,389
2166,206,198,2,1,407
2167,215,166,3,1,385
2168,214,176,0,0,390
2169,217,186,3,0,406
2170,249,144,2,0,395
2171,208,167,3,0,378
2172,219,166,1,0,386
2173,200,166,3,0,369
2174,247,156,4,0,407
2175,216,170,1,0,387
2176,224,181,4,0,409
2177,175,138,7,0,320
2178,212,142,6,1,361
2179,264,158,4,0,426
2180,270,167,7,0,444
2181,205,190,2,0,397
2182,259,163,0,0,422
2183,257,171,3,2,433
2184,253,160,3,0,416
2185,211,135,1,0,347
2186,234,140,1,0,375
2187,236,112,1,0,349
2188,232,113,5,0,350
2189,207,160,3,1,371
2190,260,161,1,2,424
2191,149,161,4,0,314
2192,160,176,4,0,340
2193,119,209,4,1,333
2194,228,190,4,2,424
2195,251,172,6,0,429
2196,259,158,1,1,419
2197,235,184,4,0,423
2198,233,200,3,0,436
2199,193,160,6,1,360
2200,194,162,2,0,358
2201,281,142,7,3,433
2202,299,156,4,1,460
2203,281,135,7,0,423
2204,308,145,6,4,463
2205,242,189,1,3,435
2206,287,135,0,0,422
2207,242,166,2,0,410
2208,266,150,5,0,421
2209,267,161,3,2,433
2210,267,150,4,1,422
2211,274,154,3,1,432
2212,272,168,7,1,448
2213,271,159,5,1,436
2214,267,162,2,1,432
2215,274,147,5,3,429
2216,273,146,1,0,420
2217,260,169,4,0,433
2218,284,157,9,0,450
2219,246,142,8,1,397
2220,233,159,2,0,394
2221,295,124,3,0,422
2222,221,105,2,0,328
2223,248,92,4,1,345
2224,252,97,0,1,350
2225,240,107,0,0,347
2226,176,113,2,1,292
2227,212,84,1,0,297
2228,196,124,0,2,322
2229,207,124,5,0,336
2230,181,131,2,0,314
2231,270,168,1,0,439
2232,299,125,0,1,425
2233,227,123,2,1,353
2234,217,141,5,1,364
2235,201,109,4,0,314
2236,219,189,3,0,411
2237,241,195,1,0,437
2238,185,202,3,0,390
2239,232,167,1,0,400
2240,197,212,3,0,412
2241,196,240,0,1,437
2242,225,181,2,1,409
2243,204,183,2,0,389
2244,229,179,6,0,414
2245,243,190,3,0,436
2246,224,196,2,0,422
2247,232,180,1,0,413
2248,191,214,1,1,407
2249,234,171,6,0,411
2250,194,195,1,0,390
2251,264,160,3,1,428
2252,239,161,5,0,405
2253,239,172,3,0,414
2254,207,193,4,1,405
2255,222,180,4,0,406
2256,254,163,2,2,421
2257,217,113,2,0,332
2258,206,144,2,0,352
2259,201,148,1,0,350
2260,236,128,1,0,365
2261,228,158,2,2,390
2262,219,208,5,0,432
2263,169,220,4,1,394
2264,212,188,1,1,402
2265,164,200,4,1,369
2266,232,169,1,1,403
2267,224,174,2,0,400
2268,192,178,3,0,373
2269,299,128,2,0,429
2270,300,119,6,0,425
2271,248,165,2,0,415
2272,320,130,3,2,455
2273,202,145,0,0,347
2274,222,145,1,1,369
2275,244,117,3,0,364
2276,228,132,1,0,361
2277,267,119,1,1,388
2278,252,148,1,1,402
2279,196,133,1,0,330
2280,215,118,1,2,336
2281,189,149,4,1,343
2282,220,123,3,1,347
2283,222,120,4,1,347
2284,181,129,3,0,313
2285,273,168,1,0,442
2286,286,177,3,1,467
2287,259,154,2,0,415
2288,142,175,3,0,320
2289,134,200,6,0,340
2290,145,183,3,0,331
2291,153,192,5,0,350
2292,139,199,1,0,339
2293,179,233,0,1,413
2294,181,225,2,0,408
2295,182,209,6,2,399
2296,130,213,2,1,346
2297,227,122,2,1,352
2298,187,147,3,0,337
2299,168,157,3,0,328
2300,161,121,4,2,288
2301,272,147,5,0,424
2302,206,156,2,0,364
2303,217,107,3,0,327
2304,191,114,1,0,306
2305,218,107,1,0,326
2306,201,150,2,0,353
2307,129,193,3,0,325
2308,141,168,3,0,312
2309,95,182,1,2,280
2310,271,138,6,0,415
2311,256,158,8,0,422
2312,228,131,1,2,362
2313,270,135,5,1,411
2314,242,184,0,1,427
2315,224,173,1,0,398
2316,197,162,3,1,363
2317,140,60,2,0,202
2318,200,141,5,1,347
2319,178,181,3,3,365
2320,196,113,0,1,310
2321,165,132,2,0,299
2322,191,94,10,0,295
2323,201,147,1,0,349
2324,204,140,2,0,346
2325,154,150,6,4,314
2326,160,153,7,2,322
2327,126,137,2,1,266
2328,128,132,2,1,263
2329,117,173,1,0,291
2330,131,128,3,1,263
2331,207,185,2,0,394
2332,259,129,4,1,393
2333,279,148,2,1,430
2334,299,136,3,0,438
2335,262,138,4,0,404
2336,303,134,4,2,443
2337,270,136,5,1,412
2338,233,152,3,2,390
2339,279,144,1,0,424
2340,280,134,3,1,418
2341,288,146,2,0,436
2342,319,117,7,2,445
2343,284,132,1,0,417
2344,263,156,2,1,422
2345,264,155,11,1,431
2346,247,166,2,1,416
2347,245,171,3,0,419
2348,263,160,3,1,427
2349,257,145,2,1,405
2350,253,154,2,0,409
2351,248,174,1,0,423
2352,269,150,4,1,424
2353,240,159,3,1,403
2354,246,157,4,0,407
2355,304,149,3,0,456
2356,252,125,5,0,382
2357,239,134,1,1,375
2358,115,36,2,1,154
2359,25,18,1,1,45
2360,30,31,0,0,61
2361,43,26,2,0,71
2362,36,31,0,0,67
2363,60,33,0,0,93
2364,54,40,2,1,97
2365,36,41,0,0,77
2366,45,28,1,0,74
2367,32,25,0,2,59
2368,24,21,0,0,45
2369,14,11,0,0,25
2370,255,169,6,0,430
2371,236,177,6,5,424
2372,210,192,3,0,405
2373,278,152,4,0,434
2374,249,152,2,0,403
2375,221,136,1,1,359
2376,240,143,5,0,388
2377,224,139,1,2,366
2378,238,161,3,0,402
2379,239,132,5,1,377
2380,238,135,3,1,377
2381,264,111,3,0,378
2382,204,171,2,0,377
2383,190,191,4,2,387
2384,139,154,1,1,295
2385,153,147,2,0,302
2386,264,144,6,0,414
2387,299,141,5,0,445
2388,273,149,5,1,428
2389,252,183,2,1,438
2390,251,156,4,1,412
2391,241,162,3,1,407
2392,245,176,2,0,423
2393,239,167,2,1,409
2394,272,166,3,1,442
2395,240,183,3,0,426
2396,248,168,4,2,422
2397,261,129,4,0,394
2398,251,166,2,0,419
2399,270,162,2,1,435
2400,212,125,2,0,339
2401,214,119,3,0,336
2402,225,133,2,1,361
2403,233,127,3,0,363
2404,250,156,2,0,408
2405,266,173,6,0,445
2406,248,182,1,1,432
2407,238,158,2,0,398
2408,225,171,2,0,398
2409,222,189,3,0,414
2410,252,172,0,0,424
2411,203,129,6,0,338
2412,185,132,5,1,323
2413,202,138,3,1,344
2414,197,131,1,1,330
2415,211,125,3,0,339
2416,246,144,3,1,394
2417,236,139,1,0,376
2418,264,125,2,1,392
2419,241,193,3,2,439
2420,208,147,3,0,358
2421,179,166,1,3,349
2422,188,158,1,0,347
2423,185,152,1,1,339
2424,205,147,1,0,353
2425,202,185,2,0,389
2426,199,119,6,1,325
2427,205,111,1,0,317
2428,157,95,0,0,252
2429,132,94,0,1,227
2430,124,49,0,0,173
2431,301,147,5,1,454
2432,214,111,6,1,332
2433,217,160,4,0,381
2434,264,161,2,2,429
2435,212,198,3,0,413
2436,174,184,0,1,359
2437,187,163,3,0,353
2438,186,196,0,0,382
2439,157,170,2,0,329
2440,181,176,5,0,362
2441,234,131,2,0,367
2442,244,123,1,1,369
2443,232,125,4,1,362
2444,194,150,2,1,347
2445,206,140,3,1,350
2446,173,122,3,0,298
2447,172,128,0,0,300
2448,226,151,2,0,379
2449,259,136,2,2,399
2450,237,176,4,1,418
2451,277,132,1,2,412
2452,224,105,1,1,331
2453,187,139,4,2,332
2454,256,128,2,0,386
2455,223,130,3,3,359
2456,216,125,2,1,344
2457,253,124,1,0,378
2458,97,146,3,0,246
2459,107,96,3,2,208
2460,172,180,0,0,352
2461,187,152,2,1,342
2462,31,25,0,1,57
2463,18,48,1,0,67
2464,338,117,4,0,459
2465,358,115,0,0,473
2466,320,145,4,0,469
2467,365,107,4,3,479
2468,349,119,2,3,473
2469,345,109,4,0,458
2470,358,111,5,0,474
2471,341,117,2,0,460
2472,359,117,3,0,479
2473,356,95,4,1,456
2474,347,111,5,1,464
2475,327,117,4,0,448
2476,361,103,2,0,466
2477,350,115,3,0,468
2478,346,102,5,1,454
2479,342,105,2,1,450
2480,342,105,3,0,450
2481,363,109,6,1,479
2482,346,100,7,0,453
2483,331,117,1,0,449
2484,305,99,7,0,411
2485,319,107,5,0,431
2486,330,113,3,0,446
2487,290,142,4,2,438
2488,289,79,4,0,372
2489,333,113,3,0,449
2490,214,73,3,1,291
2491,71,47,0,1,119
2492,177,67,4,1,249
2493,202,100,5,2,309
2494,335,116,5,0,456
2495,287,135,6,2,430
2496,296,132,4,2,434
2497,302,112,0,2,416
2498,281,117,6,0,404
2499,271,123,3,1,398
2500,319,103,1,0,423
2501,268,111,5,1,385
2502,323,87,6,2,418
2503,273,113,4,0,390
2504,281,96,6,1,384
2505,24,6,0,1,31
2506,218,123,1,4,346
2507,220,124,0,1,345
2508,227,115,5,0,347
2509,214,113,3,1,331
2510,250,95,2,1,348
2511,257,136,1,1,395
2512,231,87,5,4,327
2513,301,97,7,1,406
2514,170,43,3,1,217
2515,252,155,6,1,414
2516,245,178,4,2,429
2517,287,143,5,1,436
2518,299,144,2,1,446
2519,287,166,6,2,461
2520,146,96,1,1,244
2521,165,87,1,0,253
2522,217,56,2,0,275
2523,206,48,2,1,257
2524,222,65,5,1,293
2525,213,58,3,1,275
2526,276,76,0,0,352
2527,91,29,1,0,121
2528,126,20,1,0,147
2529,184,103,4,1,292
2530,172,102,3,0,277
2531,43,47,2,0,92
2532,64,27,0,0,91
2533,289,49,3,1,342
2534,343,113,2,0,458
2535,296,136,7,0,439
2536,302,138,4,1,445
2537,247,117,0,0,364
2538,281,114,4,0,399
2539,291,92,11,1,395
2540,237,157,3,1,398
2541,173,150,4,0,327
2542,242,121,6,2,371
2543,179,87,1,3,270
2544,227,109,3,0,339
2545,244,91,4,0,339
2546,264,89,3,0,356
2547,285,93,2,1,381
2548,268,67,2,2,339
2549,240,127,1,1,369
2550,242,133,2,1,378
2551,304,75,4,2,385
2552,286,69,6,0,361
2553,220,92,1,1,314
2554,233,106,5,1,345
2555,218,108,2,1,329
2556,204,104,3,1,312
2557,199,100,2,1,302
2558,305,118,5,0,428
2559,259,168,4,0,431
2560,233,120,3,0,356
2561,245,114,2,1,362
2562,255,106,3,0,364
2563,211,116,2,1,330
2564,193,81,1,3,278
2565,177,109,3,0,289
2566,204,100,4,1,309
2567,235,100,4,1,340
2568,207,116,5,0,328
2569,166,90,0,0,256
2570,275,123,4,2,404
2571,280,136,3,1,420
2572,286,131,2,1,420
2573,47,38,0,0,85
2574,26,38,1,0,65
2575,8,11,0,0,19
2576,177,221,1,1,400
2577,214,199,4,3,420
2578,183,150,4,0,337
2579,138,167,5,2,312
2580,154,157,8,0,319
2581,162,148,10,1,321
2582,270,155,6,0,431
2583,85,111,5,0,201
2584,76,129,5,0,210
2585,61,85,1,0,147
2586,150,276,5,1,432
2587,11,12,1,0,24
2588,163,132,4,0,299
2589,103,134,4,1,242
2590,122,112,3,6,243
2591,133,194,7,4,338
2592,142,202,4,0,348
2593,156,211,5,2,374
2594,349,117,2,2,470
2595,302,153,3,2,460
2596,288,157,4,0,449
2597,298,158,6,1,463
2598,266,166,4,2,438
2599,318,146,3,0,467
2600,308,132,4,1,445
2601,322,126,6,1,455
2602,302,141,5,1,449
2603,307,158,2,1,468
2604,265,162,6,0,433
2605,286,146,5,3,440
2606,292,163,4,1,460
2607,284,148,2,3,437
2608,286,149,6,1,442
2609,308,158,1,0,467
2610,273,165,5,2,445
2611,236,146,3,0,385
2612,250,117,4,1,372
2613,258,151,4,3,416
2614,237,177,4,0,418
2615,229,190,4,3,426
2616,192,192,6,2,392
2617,265,174,6,0,445
2618,80,150,1,0,231
2619,99,151,4,0,254
2620,224,232,4,0,460
2621,216,194,6,0,416
2622,235,209,2,0,446
2623,283,169,5,2,459
2624,149,104,4,3,260
2625,173,117,0,0,290
2626,254,86,2,0,342
2627,242,96,1,1,340
2628,210,121,1,0,332
2629,324,169,4,3,500
2630,306,148,9,0,463
2631,344,155,2,1,502
2632,262,144,4,1,411
2633,270,149,2,2,423
2634,309,115,3,0,427
2635,227,100,3,1,331
2636,154,106,4,0,264
2637,208,96,2,0,306
2638,274,133,7,4,418
2639,271,165,6,2,444
2640,388,141,5,1,535
2641,279,177,6,0,462
2642,303,160,6,2,471
2643,308,167,2,0,477
2644,276,183,3,0,462
2645,264,133,9,3,409
2646,285,106,2,0,393
2647,262,136,1,1,400
2648,296,162,9,2,469
2649,332,133,5,3,473
2650,310,158,7,1,476
2651,253,125,3,0,381
2652,282,132,1,0,415
2653,225,107,0,2,334
2654,230,145,2,0,377
2655,159,46,1,1,207
2656,201,119,2,0,322
2657,171,101,9,1,282
2658,24,21,0,0,45
2659,224,162,6,0,392
2660,211,145,1,2,359
2661,237,130,4,0,371
2662,240,130,2,2,374
2663,240,101,0,1,342
2664,248,139,3,0,390
2665,239,162,4,1,406
2666,236,123,6,2,367
2667,215,87,8,1,311
2668,218,115,3,0,336
2669,226,128,2,1,357
2670,74,65,3,2,144
2671,218,186,7,2,413
2672,221,175,7,0,403
2673,186,172,4,2,364
2674,101,68,2,0,171
2675,151,126,2,0,279
2676,41,32,0,0,73
2677,120,130,3,0,253
2678,69,122,3,0,194
2679,96,101,0,0,197
2680,82,123,1,1,207
2681,93,112,0,0,205
2682,76,133,2,0,211
2683,15,32,0,0,47
2684,71,61,2,1,135
2685,14,14,0,1,29
2686,248,203,2,1,454
2687,241,200,4,0,445
2688,204,178,3,0,385
2689,282,171,1,0,454
2690,274,175,5,0,454
2691,207,147,4,0,358
2692,175,175,4,0,354
2693,156,183,3,4,346
2694,139,172,2,2,315
2695,199,150,0,2,351
2696,185,109,3,0,297
2697,211,97,1,2,311
2698,101,106,1,1,209
2699,189,234,4,0,427
2700,185,248,1,1,435
2701,268,113,3,0,384
2702,232,142,2,3,379
2703,250,117,4,2,373
2704,251,104,3,0,358
2705,238,131,3,0,372
2706,209,136,1,1,347
2707,187,142,2,1,332
2708,182,139,1,0,322
2709,160,100,1,0,261
2710,151,109,2,0,262
2711,169,91,2,0,262
2712,173,88,0,1,262
2713,90,72,1,1,164
2714,235,110,4,1,350
2715,217,99,3,0,319
2716,249,121,3,0,373
2717,261,86,1,1,349
2718,27,26,2,0,55
2719,32,9,0,0,41
2720,220,60,1,3,284
2721,65,14,1,0,80
2722,163,101,2,0,266
2723,159,100,2,0,261
2724,273,145,2,0,420
2725,149,91,2,0,242
2726,354,85,4,2,445
2727,340,112,2,0,454
2728,303,153,5,3,464
2729,324,133,2,1,460
2730,289,116,3,3,411
2731,276,139,1,1,417
2732,318,106,4,2,430
2733,270,134,2,1,407
2734,314,113,6,2,435
2735,332,101,7,0,440
2736,316,108,0,1,425
2737,318,101,0,3,422
2738,25,4,0,1,30
2739,291,85,1,0,377
2740,226,102,2,1,331
2741,276,61,2,3,342
2742,250,80,2,1,333
2743,326,145,3,1,475
2744,252,131,5,0,388
2745,281,150,2,1,434
2746,327,123,4,0,454
2747,257,131,1,0,389
2748,252,112,5,0,369
2749,381,104,0,1,486
2750,227,95,3,0,325
2751,256,76,0,0,332
2752,162,89,1,1,253
2753,171,78,4,1,254
2754,245,125,2,2,374
2755,269,124,2,1,396
2756,235,143,2,1,381
2757,258,145,2,0,405
2758,285,170,3,0,458
2759,277,154,1,1,433
2760,243,177,2,0,422
2761,172,177,4,1,354
2762,165,157,4,0,326
2763,184,176,1,0,361
2764,233,101,3,3,340
2765,42,28,0,0,70
2766,298,128,4,2,432
2767,258,166,2,3,429
2768,273,147,3,0,423
2769,328,130,2,0,460
2770,279,145,3,3,430
2771,237,145,3,0,385
2772,265,163,3,1,432
2773,287,123,4,1,415
2774,276,149,0,1,426
2775,302,126,5,2,435
2776,256,111,1,1,369
2777,236,139,3,2,380
2778,235,139,3,0,377
2779,301,134,1,1,437
2780,233,133,5,1,372
2781,259,117,0,2,378
2782,246,122,4,0,372
2783,266,105,1,0,372
2784,173,114,5,0,292
2785,147,129,4,1,281
2786,235,147,3,2,387
2787,227,165,4,0,396
2788,268,124,1,2,395
2789,20,4,1,0,25
2790,270,159,2,0,431
2791,243,171,1,3,418
2792,277,124,1,0,402
2793,189,151,2,1,343
2794,170,97,0,0,267
2795,310,130,6,1,447
2796,314,110,5,3,432
2797,178,107,3,0,288
2798,260,66,6,2,334
2799,139,42,2,0,183
2800,300,120,1,1,422
2801,238,165,3,1,407
2802,286,166,3,1,456
2803,247,111,3,2,363
2804,226,114,2,0,342
2805,253,116,5,3,377
2806,232,120,1,1,354
2807,215,112,2,0,329
2808,178,145,3,1,327
2809,256,136,2,0,394
2810,154,65,0,0,219
2811,254,90,3,0,347
2812,261,100,2,1,364
2813,234,125,1,2,362
2814,198,130,4,0,332
2815,228,116,4,1,349
2816,220,143,3,0,366
2817,175,162,4,0,341
2818,193,151,2,0,346
2819,219,145,6,1,371
2820,239,177,3,0,419
2821,66,26,0,0,92
2822,230,73,4,1,308
2823,241,68,3,1,313
2824,209,86,5,1,301
2825,260,100,7,2,369
2826,304,72,3,1,380
2827,283,91,3,2,379
2828,284,95,4,0,383
2829,347,120,2,1,470
2830,340,115,4,2,461
2831,351,134,4,1,490
2832,315,122,5,0,442
2833,338,104,1,1,444
2834,294,78,3,3,378
2835,296,100,2,0,398
2836,284,93,4,0,381
2837,309,91,5,2,407
2838,290,108,2,0,400
2839,266,101,7,0,374
2840,276,103,2,1,382
2841,279,92,6,0,377
2842,296,99,4,1,400
2843,332,99,5,1,437
2844,314,77,3,0,394
2845,273,93,1,1,368
2846,316,75,0,0,391
2847,298,94,1,0,393
2848,340,109,3,0,452
2849,242,120,3,0,365
2850,284,122,1,0,407
2851,224,121,5,0,350
2852,263,88,3,0,354
2853,316,135,3,0,454
2854,327,124,5,0,456
2855,314,128,4,1,447
2856,302,134,1,0,437
2857,319,132,9,2,462
2858,329,130,7,4,470
2859,346,113,2,1,462
2860,277,117,7,2,403
2861,298,114,2,0,414
2862,338,92,4,1,435
2863,308,122,6,0,436
2864,352,83,4,1,440
2865,224,114,3,1,342
2866,225,134,4,0,363
2867,260,129,2,1,392
2868,272,166,4,1,443
2869,262,170,1,0,433
2870,275,167,5,2,449
2871,290,157,3,0,450
2872,258,177,0,1,436
2873,266,131,1,0,398
2874,259,124,4,1,388
2875,266,131,3,0,400
2876,302,159,3,1,465
2877,322,119,5,1,447
2878,337,150,0,1,488
2879,323,133,3,0,459
2880,310,91,6,0,407
2881,30,12,2,1,45
2882,320,152,1,0,473
2883,352,108,2,0,462
2884,327,115,5,2,449
2885,318,124,0,0,442
2886,326,133,1,2,462
2887,310,128,5,1,444
2888,360,128,2,0,490
2889,362,97,3,1,463
2890,354,129,3,1,487
2891,340,119,2,0,461
2892,355,139,1,1,496
2893,149,87,2,3,241
2894,147,121,3,0,271
2895,16,7,0,1,24
2896,271,174,1,0,446
2897,239,166,3,0,408
2898,276,139,3,1,419
2899,161,103,0,0,264
2900,148,91,1,0,240
2901,331,133,2,4,470
2902,369,102,3,2,476
2903,310,125,3,0,438
2904,349,107,4,1,461
2905,387,109,7,1,504
2906,213,96,5,0,314
2907,189,128,2,0,319
2908,252,173,3,0,428
2909,201,190,2,0,393
2910,218,202,5,0,425
2911,227,186,4,0,417
2912,216,212,2,0,430
2913,182,147,6,0,335
2914,180,146,4,0,330
2915,220,144,4,1,369
2916,220,127,2,0,349
2917,204,145,2,1,352
2918,201,149,3,1,354
2919,257,137,6,2,402
2920,182,224,4,0,410
2921,173,204,4,1,382
2922,183,194,1,0,378
2923,233,150,1,0,384
2924,253,140,2,1,396
2925,253,126,1,0,380
2926,259,119,3,0,381
2927,243,140,2,2,387
2928,270,145,1,2,418
2929,272,134,2,0,408
2930,219,166,6,1,392
2931,246,132,2,1,381
2932,275,108,4,0,387
2933,245,115,0,0,360
2934,218,101,4,0,323
2935,178,115,1,0,294
2936,194,102,0,0,296
2937,15,3,0,3,21
2938,207,105,0,0,312
2939,212,109,2,0,323
2940,195,135,1,1,332
2941,203,100,1,0,304
2942,172,119,0,0,291
2943,156,97,5,0,258
2944,167,116,1,0,284
2945,169,100,1,1,271
2946,132,93,2,1,228
2947,111,138,3,0,252
2948,114,156,2,0,272
2949,95,158,2,0,255
2950,90,40,1,0,131
2951,92,81,1,1,175
2952,98,62,1,0,161
2953,108,208,0,2,318
2954,270,155,6,2,433
2955,254,176,8,0,438
2956,245,168,2,0,415
2957,254,158,5,1,418
2958,249,164,5,1,419
2959,237,180,7,3,427
2960,222,186,1,7,416
2961,283,141,3,1,428
2962,196,142,5,2,345
2963,239,122,2,2,365
2964,204,169,2,0,375
2965,205,157,4,0,366
2966,294,129,2,0,425
2967,168,113,7,1,289
2968,179,128,1,1,309
2969,279,144,4,3,430
2970,329,160,5,2,496
2971,149,53,0,1,203
2972,136,135,1,1,273
2973,125,145,1,0,271
2974,210,204,5,0,419
2975,177,201,8,1,387
2976,201,164,2,0,367
2977,205,150,3,0,358
2978,200,142,3,0,345
2979,206,220,3,1,430
2980,216,203,5,0,424
2981,179,205,6,1,391
2982,164,181,3,0,348
2983,155,204,2,0,361
2984,169,217,3,0,389
2985,31,27,0,0,58
2986,301,152,7,0,460
2987,257,174,1,0,432
2988,255,176,5,2,438
2989,261,171,3,0,435
2990,250,144,2,1,397
2991,259,149,3,1,412
2992,235,163,2,1,401
2993,96,189,4,1,290
2994,121,176,4,0,301
2995,263,182,2,0,447
2996,248,184,3,1,436
2997,222,198,5,1,426
2998,231,183,4,0,418
2999,219,190,2,0,411
3000,243,167,4,2,416
3001,207,158,7,1,373
3002,211,142,7,0,360
3003,214,132,0,0,346
3004,207,147,7,1,362
3005,17,20,0,4,41
3006,127,198,1,1,327
3007,113,216,4,0,333
3008,37,41,1,0,79
3009,224,147,1,0,372
3010,190,152,1,0,343
3011,194,171,6,1,372
3012,168,133,2,0,303
3013,317,146,7,2,472
3014,287,166,1,0,454
3015,258,146,2,1,407
3016,278,146,3,2,429
3017,231,156,2,1,390
3018,216,198,5,3,422
3019,194,200,1,1,396
3020,172,170,2,0,344
3021,170,169,4,0,343
3022,178,149,2,2,331
3023,205,199,1,2,407
3024,91,105,2,1,199
3025,128,192,2,0,322
3026,132,178,4,2,316
3027,208,209,3,2,422
3028,192,166,3,0,361
3029,168,145,3,2,318
3030,228,181,3,1,413
3031,120,246,2,0,368
3032,95,267,3,0,365
3033,174,211,6,1,392
3034,200,190,6,0,396
3035,52,55,0,0,107
3036,67,54,0,0,121
3037,120,158,2,3,283
3038,149,134,2,0,285
3039,121,114,3,2,240
3040,107,114,1,0,222
3041,87,102,2,0,191
3042,178,224,2,0,404
3043,190,239,2,0,431
3044,175,225,5,1,406
3045,163,232,7,1,403
3046,182,234,1,1,418
3047,155,220,4,0,379
3048,153,238,1,1,393
3049,167,207,4,1,379
3050,175,226,3,1,405
3051,202,210,6,1,419
3052,134,222,3,1,360
3053,160,208,3,1,372
3054,179,215,7,1,402
3055,137,234,7,0,378
3056,112,209,3,2,326
3057,138,214,4,1,357
3058,98,310,3,0,411
3059,146,298,5,2,451
3060,99,205,3,0,307
3061,64,335,2,1,402
3062,139,161,1,0,301
3063,116,162,0,1,279
3064,113,134,4,1,252
3065,47,169,3,1,220
3066,65,163,0,0,228
3067,113,157,5,2,277
3068,158,142,1,0,301
3069,229,194,2,4,429
3070,232,193,5,1,431
3071,192,145,0,1,338
3072,180,161,4,1,346
3073,190,169,1,1,361
3074,210,161,3,0,374
3075,214,142,4,1,361
3076,142,144,2,1,289
3077,153,135,1,5,294
3078,126,226,1,4,357
3079,132,232,5,1,370
3080,237,160,7,0,404
3081,183,185,6,1,375
3082,164,177,7,1,349
3083,183,169,11,0,363
3084,154,130,1,3,288
3085,145,152,4,0,301
3086,175,140,4,2,321
3087,164,149,2,0,315
3088,150,162,1,0,313
3089,226,154,4,2,386
3090,185,175,6,1,367
3091,203,172,4,3,382
3092,155,190,1,2,348
3093,74,143,0,0,217
3094,52,90,1,0,143
3095,146,141,4,1,292
3096,136,148,3,0,287
3097,162,139,0,0,301
3098,81,53,3,0,137
3099,177,209,2,2,390
3100,179,213,8,0,400
3101,171,229,0,0,400
3102,189,193,4,1,387
3103,165,231,2,1,399
3104,168,230,7,0,405
3105,206,177,1,0,384
3106,184,207,4,2,397
3107,202,195,6,0,403
3108,176,195,7,1,379
3109,51,49,1,0,101
3110,48,35,3,0,86
3111,187,174,1,2,364
3112,179,203,4,0,386
3113,184,192,4,1,381
3114,195,210,1,0,406
3115,123,203,3,1,330
3116,121,216,1,2,340
3117,204,181,5,0,390
3118,173,202,4,1,380
3119,174,139,7,1,321
3120,155,171,3,2,331
3121,160,170,2,0,332
3122,180,200,5,2,387
3123,189,200,4,2,395
3124,184,181,3,1,369
3125,42,63,2,0,107
3126,230,176,2,0,408
3127,188,176,4,0,368
3128,114,202,0,0,316
3129,135,178,6,1,320
3130,95,169,2,0,266
3131,114,128,2,2,246
3132,155,103,1,0,259
3133,42,71,0,0,113
3134,33,54,1,0,88
3135,109,168,6,0,283
3136,104,177,4,0,285
3137,73,122,3,0,198
3138,83,139,0,0,222
3139,141,108,3,1,253
3140,137,187,6,0,330
3141,117,194,2,0,313
3142,88,176,3,2,269
3143,115,225,3,1,344
3144,35,43,0,0,78
3145,105,66,0,5,176
3146,133,119,3,1,256
3147,18,106,0,1,125
3148,73,56,3,1,133
3149,133,183,3,1,320
3150,41,59,0,0,100
3151,92,189,2,0,283
3152,34,67,4,1,106
3153,16,75,0,0,91
3154,146,180,6,1,333
3155,170,176,0,2,348
3156,188,180,4,1,373
3157,17,31,0,1,49
3158,49,100,1,0,150
3159,47,46,1,0,94
3160,31,45,0,1,77
3161,143,154,1,0,298
3162,67,159,2,4,232
3163,71,68,1,0,140
3164,131,244,6,1,382
3165,123,225,4,1,353
3166,126,216,3,0,345
3167,120,243,4,0,367
3168,74,209,1,0,284
3169,128,189,7,1,325
3170,131,180,0,2,313
3171,113,212,4,3,332
3172,16,47,0,0,63
3173,70,74,2,1,147
3174,93,172,1,0,266
3175,28,89,2,0,119
3176,41,49,0,0,90
3177,43,51,0,0,94
3178,111,166,6,2,285
3179,44,64,0,0,108
3180,82,134,0,0,216
3181,24,34,0,1,59
3182,346,115,7,3,471
3183,323,119,5,6,453
3184,263,108,3,0,374
3185,264,103,7,1,375
3186,279,110,3,1,393
3187,309,87,5,0,401
3188,278,109,6,2,395
3189,17,11,0,0,28
3190,328,118,3,1,450
3191,323,90,3,0,416
3192,251,100,2,1,354
3193,297,106,0,1,404
3194,63,22,2,0,87
3195,158,72,3,3,236
3196,36,9,0,3,48
3197,284,97,2,1,384
3198,237,90,1,0,328
3199,146,59,6,0,211
3200,75,18,8,3,104
3201,251,88,2,4,345
3202,315,71,5,0,391
3203,196,64,2,0,262
3204,309,130,7,1,447
3205,266,160,4,2,432
3206,250,152,3,0,405
3207,248,181,5,0,434
3208,259,147,2,0,408
3209,247,168,3,1,419
3210,303,129,4,0,436
3211,256,143,1,0,400
3212,231,124,4,3,362
3213,43,44,1,0,88
3214,162,85,1,0,248
3215,170,85,1,0,256
3216,241,177,2,0,420
3217,272,127,3,0,402
3218,288,139,3,0,430
3219,216,135,2,1,354
3220,240,138,1,1,380
3221,222,157,3,2,384
3222,223,120,2,0,345
3223,206,157,2,1,366
3224,73,64,0,1,138
3225,213,137,5,0,355
3226,234,113,5,1,353
3227,199,134,4,0,337
3228,150,138,2,0,290
3229,125,127,2,0,254
3230,242,165,0,0,407
3231,253,135,5,0,393
3232,175,106,1,1,283
3233,119,193,3,1,316
3234,153,183,3,0,339
3235,149,175,1,1,326
3236,130,193,5,1,329
3237,144,185,3,1,333
3238,153,188,3,0,344
3239,134,140,1,1,276
3240,160,141,5,0,306
3241,143,160,3,1,307
3242,138,162,2,1,303
3243,108,216,3,0,327
3244,104,201,6,3,314
3245,68,198,1,0,267
3246,42,142,4,2,190
3247,87,138,1,0,226
3248,73,87,1,2,163
3249,105,138,2,0,245
3250,113,129,6,0,248
3251,56,56,1,0,113
3252,91,123,2,0,216
3253,52,68,1,0,121
3254,100,139,3,0,242
3255,108,104,2,0,214
3256,12,73,1,0,86
3257,81,149,5,0,235
3258,52,110,5,1,168
3259,61,88,3,3,155
3260,94,141,3,2,240
3261,76,92,0,0,168
3262,69,136,4,0,209
3263,69,112,1,0,182
3264,53,138,4,1,196
3265,46,124,0,1,171
3266,44,97,4,0,145
3267,26,44,1,0,71
3268,41,105,1,0,147
3269,43,109,1,0,153
3270,28,100,0,0,128
3271,168,233,3,2,406
3272,188,210,1,0,399
3273,182,223,5,2,412
3274,175,185,2,3,365
3275,57,78,1,0,136
3276,45,80,2,0,127
3277,55,55,0,1,111
3278,74,120,1,4,199
3279,66,88,6,0,160
3280,65,82,3,0,150
3281,146,162,1,0,309
3282,75,116,0,0,191
3283,129,201,4,3,337
3284,42,104,4,0,150
3285,51,86,1,0,138
3286,44,146,1,1,192
3287,62,76,1,0,139
3288,29,109,2,0,140
3289,83,114,2,0,199
3290,66,100,2,0,168
3291,85,112,4,0,201
3292,79,83,1,0,163
3293,67,67,1,2,137
3294,101,158,2,0,261
3295,120,149,3,2,274
3296,77,189,3,0,269
3297,101,159,4,0,264
3298,100,153,2,0,255
3299,10,16,0,0,26
3300,102,89,3,0,194
3301,85,93,4,0,182
3302,159,158,1,1,319
3303,164,145,2,1,312
3304,170,148,3,1,322
3305,140,112,2,2,256
3306,153,105,1,0,259
3307,143,165,0,0,308
3308,4,31,0,0,35
3309,60,91,3,1,155
3310,20,61,0,1,82
3311,13,26,1,0,40
3312,66,200,2,0,268
3313,101,169,5,0,275
3314,96,142,0,0,238
3315,35,109,0,0,144
3316,54,95,3,1,153
3317,97,115,0,1,213
3318,88,101,1,0,190
3319,60,147,6,0,213
3320,57,100,0,1,158
3321,56,96,2,0,154
3322,83,30,2,1,116
3323,42,70,1,0,113
3324,152,202,5,2,361
3325,124,199,2,3,328
3326,116,184,2,0,302
3327,14,49,0,0,63
3328,15,85,0,0,100
3329,60,96,0,1,157
3330,156,186,4,0,346
3331,97,125,3,0,225
3332,35,49,0,0,84
3333,117,208,6,0,331
3334,128,212,4,0,344
3335,112,192,5,1,310
3336,119,173,2,0,294
3337,112,181,2,0,295
3338,114,160,3,1,278
3339,36,30,1,0,67
3340,101,196,3,0,300
3341,94,94,5,2,195
3342,71,97,1,2,171
3343,39,180,2,0,221
3344,81,120,2,1,204
3345,6,25,1,0,32
3346,74,156,3,0,233
3347,74,174,3,2,253
3348,82,147,0,0,229
3349,22,62,0,0,84
3350,134,164,5,1,304
3351,91,224,1,0,316
3352,67,210,6,0,283
3353,80,205,5,0,290
3354,97,212,2,0,311
3355,71,126,3,0,200
3356,59,124,0,1,184
3357,62,211,6,2,281
3358,69,177,5,1,252
3359,383,79,2,0,464
3360,392,87,3,1,483
3361,397,81,5,0,483
3362,389,80,2,3,474
3363,393,83,2,1,479
3364,370,88,5,2,465
3365,385,79,6,1,471
3366,397,74,7,0,478
3367,409,62,9,0,480
3368,375,101,9,0,485
3369,381,74,4,4,463
3370,386,90,4,0,480
3371,394,77,1,2,474
3372,408,84,8,2,502
3373,413,78,5,3,499
3374,379,77,8,0,464
3375,380,98,3,1,482
3376,373,98,2,1,474
3377,399,85,3,1,488
3378,332,63,6,2,403
3379,343,58,8,0,409
3380,320,65,1,1,387
3381,367,66,8,1,442
3382,405,74,6,0,485
3383,353,89,5,0,447
3384,370,116,3,1,490
3385,378,77,3,2,460
3386,403,84,2,0,489
3387,408,82,3,1,494
3388,382,90,1,0,473
3389,380,76,5,2,463
3390,385,87,11,3,486
3391,387,76,5,0,468
3392,377,87,6,1,471
3393,373,106,3,0,482
3394,309,77,6,2,394
3395,313,89,3,1,406
3396,296,90,1,0,387
3397,329,81,1,0,411
3398,335,97,4,2,438
3399,32,13,0,0,45
3400,393,60,7,2,462
3401,364,78,6,0,448
3402,360,80,7,1,448
3403,392,76,3,0,471
3404,376,78,1,1,456
3405,345,92,3,2,442
3406,354,92,2,0,448
3407,333,67,5,0,405
3408,316,72,2,0,390
3409,292,77,1,0,370
3410,290,90,3,0,383
3411,296,53,7,0,356
3412,368,73,0,0,441
3413,386,68,5,2,461
3414,389,102,7,0,498
3415,383,88,2,0,473
3416,383,100,4,2,489
3417,376,99,4,0,479
3418,364,96,4,1,465
3419,380,96,6,1,483
3420,374,80,4,1,459
3421,369,100,3,1,473
3422,420,85,6,1,512
3423,323,96,6,0,425
3424,384,95,4,0,483
3425,348,100,1,0,449
3426,370,80,2,1,453
3427,367,102,4,2,475
3428,365,109,6,0,480
3429,381,74,4,1,460
3430,354,111,1,0,466
3431,351,83,1,2,437
3432,326,87,3,1,417
3433,321,77,1,0,399
3434,299,89,4,1,393
3435,306,100,4,3,413
3436,336,83,7,1,427
3437,296,91,5,1,393
3438,286,88,2,0,376
3439,241,90,2,0,333
3440,255,99,3,1,358
3441,264,101,4,2,371
3442,252,105,3,0,360
3443,292,107,3,0,402
3444,311,131,7,0,449
3445,287,155,4,0,446
3446,267,174,2,0,443
3447,260,116,1,0,377
3448,248,134,4,0,386
3449,242,115,6,1,364
3450,220,125,3,0,348
3451,264,138,5,1,408
3452,325,109,5,1,440
3453,295,83,2,1,381
3454,297,85,2,1,385
3455,299,69,3,2,373
3456,275,129,2,1,407
3457,375,96,5,0,476
3458,386,87,3,0,476
3459,379,104,2,1,486
3460,337,119,9,1,466
3461,371,110,6,3,490
3462,384,104,5,1,494
3463,333,122,5,4,464
3464,387,110,4,0,501
3465,348,109,5,0,462
3466,385,91,7,2,485
3467,327,140,4,1,472
3468,353,114,8,2,477
3469,354,122,0,0,476
3470,392,103,4,0,499
3471,350,100,6,1,457
3472,275,74,5,1,355
3473,279,88,1,2,370
3474,314,75,3,1,393
3475,297,73,5,1,376
3476,306,74,3,0,383
3477,366,110,5,2,483
3478,381,111,2,0,494
3479,377,115,4,2,498
3480,352,121,5,0,478
3481,366,93,6,2,467
3482,365,113,4,1,483
3483,372,104,0,1,477
3484,383,94,6,1,484
3485,358,131,3,3,495
3486,343,118,4,3,468
3487,317,91,8,0,416
3488,338,100,2,2,442
3489,367,66,3,0,436
3490,252,147,7,1,407
3491,283,119,14,0,416
3492,277,143,4,0,424
3493,297,137,3,1,438
3494,289,142,9,1,441
3495,250,149,8,1,408
3496,243,136,5,3,387
3497,220,138,3,2,363
3498,224,121,4,0,349
3499,245,130,3,1,379
3500,378,100,4,1,483
3501,363,90,1,4,458
3502,407,75,5,2,489
3503,380,97,7,0,484
3504,363,97,2,1,463
3505,377,105,2,0,484
3506,371,80,4,3,458
3507,390,92,1,0,483
3508,384,85,1,0,470
3509,368,103,1,0,472
3510,377,102,3,1,483
3511,373,102,3,0,478
3512,378,79,2,1,460
3513,378,105,7,0,490
3514,383,91,7,0,481
3515,417,78,4,1,500
3516,307,70,4,2,383
3517,288,95,5,0,388
3518,306,71,2,0,379
3519,295,76,4,0,375
3520,248,88,1,0,337
3521,241,118,2,0,361
3522,255,82,3,2,342
3523,330,95,5,2,432
3524,295,113,1,2,411
3525,284,103,3,2,392
3526,219,91,1,0,311
3527,342,105,2,3,452
3528,311,116,2,6,435
3529,276,104,2,1,383
3530,264,99,4,0,367
3531,263,49,2,0,314
3532,269,41,3,1,314
3533,175,65,3,3,246
3534,143,68,1,0,212
3535,223,81,3,2,309
3536,176,75,2,0,253
3537,189,90,6,1,286
3538,418,36,5,2,461
3539,418,64,2,1,485
3540,437,37,4,3,481
3541,406,48,7,4,465
3542,389,59,2,1,451
3543,388,37,5,1,431
3544,357,48,3,1,409
3545,324,26,6,0,356
3546,397,96,5,2,500
3547,392,85,9,0,486
3548,389,93,10,5,497
3549,396,90,5,2,493
3550,333,67,6,2,408
3551,334,60,6,0,400
3552,343,70,8,1,422
3553,322,74,3,1,400
3554,123,42,2,0,167
3555,365,105,6,1,477
3556,357,114,6,2,479
3557,351,110,3,0,464
3558,383,95,3,1,482
3559,352,119,3,1,475
3560,396,95,3,0,494
3561,321,50,7,0,378
3562,352,52,3,0,407
3563,324,73,0,1,398
3564,327,57,5,0,389
3565,294,63,1,1,359
3566,255,72,4,1,332
3567,329,96,5,1,431
3568,351,107,4,0,462
3569,350,85,4,0,439
3570,357,119,6,2,484
3571,346,106,6,0,458
3572,207,68,5,1,281
3573,194,70,5,0,269
3574,212,67,3,1,283
3575,142,46,5,2,195
3576,353,113,1,0,467
3577,351,100,2,1,454
3578,372,101,2,0,475
3579,406,69,1,0,476
3580,385,95,2,1,483
3581,345,107,1,0,453
3582,377,95,8,0,480
3583,370,100,6,0,476
3584,361,103,4,0,468
3585,387,69,5,2,463
3586,318,106,6,1,431
3587,371,95,2,1,469
3588,398,84,4,1,487
3589,400,92,4,0,496
3590,376,82,3,1,462
3591,367,96,3,0,466
3592,405,76,5,2,488
3593,375,97,3,1,476
3594,373,91,3,0,467
3595,405,89,3,0,497
3596,375,94,2,0,471
3597,376,85,4,0,465
3598,396,84,4,0,484
3599,405,85,5,0,495
3600,382,85,5,0,472
3601,397,90,4,0,491
3602,351,104,5,0,460
3603,307,122,1,0,430
3604,293,132,3,1,429
3605,247,106,3,0,356
3606,203,83,1,0,287
3607,214,61,1,2,278
3608,237,69,1,1,308
3609,230,136,4,1,371
3610,230,147,1,0,378
3611,188,138,1,0,327
3612,235,50,1,0,286
3613,203,69,2,2,276
3614,214,151,3,0,368
3615,269,100,2,1,372
3616,178,44,3,1,226
3617,289,80,1,2,372
3618,386,91,3,1,481
3619,386,72,3,0,461
3620,365,76,2,2,445
3621,374,76,1,1,452
3622,383,80,5,0,468
3623,311,60,5,0,376
3624,354,32,4,0,390
3625,289,56,3,0,348
3626,209,41,5,0,255
3627,212,42,0,0,254
3628,277,61,3,1,342
3629,292,86,5,3,386
3630,348,67,2,0,417
3631,114,33,1,0,148
3632,229,52,5,0,286
3633,362,99,2,1,464
3634,382,106,5,1,494
3635,319,126,4,0,449
3636,354,92,3,0,449
3637,287,89,0,4,380
3638,301,63,3,2,369
3639,365,56,3,1,425
3640,139,34,1,1,175
3641,272,24,3,1,300
3642,38,22,1,0,61
3643,288,140,3,1,432
3644,303,134,4,0,441
3645,346,113,4,0,463
3646,273,146,5,0,424
3647,280,156,4,2,442
3648,292,148,3,1,444
3649,285,121,6,1,413
3650,303,147,7,1,458
3651,317,126,4,1,448
3652,278,138,1,0,417
3653,309,130,1,0,440
3654,310,131,2,1,444
3655,285,133,5,2,425
3656,309,128,5,0,442
3657,287,138,11,0,436
3658,301,127,7,1,436
3659,327,137,2,1,467
3660,309,125,2,0,436
3661,232,110,1,0,343
3662,300,137,2,1,440
3663,334,127,9,3,473
3664,345,124,4,1,474
3665,321,139,2,1,463
3666,324,135,4,0,463
3667,334,124,4,0,462
3668,346,122,4,0,472
3669,354,123,2,2,481
3670,327,119,2,0,448
3671,294,150,3,3,450
3672,331,119,3,0,453
3673,334,124,2,1,461
3674,337,123,2,2,464
3675,326,117,5,1,449
3676,330,117,3,1,451
3677,368,112,2,2,484
3678,338,127,3,1,469
3679,267,102,5,0,374
3680,276,108,4,2,390
3681,297,116,6,0,419
3682,281,136,4,0,421
3683,265,162,6,2,435
3684,277,150,8,0,435
3685,292,150,7,0,449
3686,253,190,5,1,449
3687,276,153,0,1,430
3688,268,157,1,1,427
3689,279,145,4,1,429
3690,293,139,2,3,437
3691,249,113,2,1,365
3692,254,151,3,2,410
3693,214,163,4,0,381
3694,221,175,5,1,402
3695,207,182,3,0,392
3696,204,159,4,0,367
3697,201,166,3,1,371
3698,197,175,3,1,376
3699,187,186,4,3,380
3700,186,155,2,2,345
3701,174,146,4,0,324
3702,197,161,6,0,364
3703,194,166,3,1,364
3704,198,175,3,0,376
3705,292,139,4,3,438
3706,285,153,4,1,443
3707,298,148,6,0,452
3708,309,114,8,0,431
3709,291,133,5,1,430
3710,298,160,0,2,460
3711,300,116,5,0,421
3712,304,118,2,1,425
3713,271,179,5,2,457
3714,282,171,7,2,462
3715,250,133,5,0,388
3716,240,127,5,0,372
3717,248,129,2,3,382
3718,251,126,4,3,384
3719,241,139,0,1,381
3720,266,148,1,1,416
3721,332,137,2,0,471
3722,307,137,3,0,447
3723,330,134,6,3,473
3724,301,136,3,2,442
3725,314,148,6,0,468
3726,276,114,0,0,390
3727,286,110,6,1,403
3728,269,145,3,1,418
3729,241,136,6,1,384
3730,219,154,3,1,377
3731,146,206,6,2,360
3732,178,187,4,3,372
3733,149,164,5,1,319
3734,157,159,1,0,317
3735,235,126,3,0,364
3736,257,100,2,1,360
3737,303,143,3,0,449
3738,304,156,6,0,466
3739,292,145,1,0,438
3740,309,142,3,4,458
3741,320,140,3,2,465
3742,300,125,6,0,431
3743,279,133,1,0,413
3744,297,141,6,1,445
3745,273,176,2,2,453
3746,284,151,1,0,436
3747,297,127,4,0,428
3748,291,130,2,0,423
3749,298,147,5,2,452
3750,297,145,7,1,450
3751,241,126,1,1,369
3752,275,131,5,0,411
3753,157,98,3,1,259
3754,165,85,2,0,252
3755,151,138,3,0,292
3756,186,124,3,0,313
3757,164,122,4,1,291
3758,170,110,1,0,281
3759,122,90,2,0,214
3760,240,126,2,0,368
3761,232,149,4,2,387
3762,288,122,0,1,411
3763,240,151,4,0,395
3764,260,127,5,1,393
3765,262,122,3,0,387
3766,250,166,4,1,421
3767,195,141,1,1,338
3768,206,127,4,1,338
3769,202,148,6,0,356
3770,222,123,6,2,353
3771,271,171,4,1,447
3772,279,168,7,0,454
3773,307,140,3,0,450
3774,258,159,4,3,424
3775,238,127,3,1,369
3776,268,117,3,0,388
3777,28,7,6,1,42
3778,154,167,2,1,324
3779,198,141,5,0,344
3780,175,127,6,2,310
3781,133,150,2,0,285
3782,167,173,7,1,348
3783,120,195,2,0,317
3784,141,171,3,1,316
3785,125,164,4,1,294
3786,109,196,3,0,308
3787,101,198,2,1,302
3788,98,190,3,0,291
3789,367,80,3,2,452
3790,325,53,7,0,385
3791,301,61,5,0,367
3792,321,50,0,0,371
3793,343,45,1,0,389
3794,329,68,3,0,400
3795,234,83,1,1,319
3796,263,87,2,0,352
3797,248,86,6,0,340
3798,33,11,0,0,44
3799,281,145,3,1,430
3800,7,2,0,0,9
3801,157,42,2,0,201
3802,337,115,1,1,454
3803,293,120,3,1,417
3804,273,128,5,1,407
3805,317,82,1,0,400
3806,168,88,3,1,260
3807,130,97,3,0,230
3808,159,79,0,0,238
3809,150,106,2,1,259
3810,253,101,3,0,357
3811,259,82,4,1,346
3812,254,109,4,0,367
3813,266,94,3,1,364
3814,43,87,0,0,130
3815,401,112,4,1,518
3816,320,114,4,0,438
3817,324,120,2,1,447
3818,350,107,3,0,460
3819,324,107,1,0,432
3820,360,104,5,0,469
3821,287,90,9,1,387
3822,280,86,9,0,375
3823,302,98,3,0,403
3824,283,83,2,0,368
3825,245,91,3,1,340
3826,259,79,2,1,341
3827,272,78,1,0,351
3828,271,60,2,0,333
3829,236,61,1,0,298
3830,225,57,3,0,285
3831,211,77,3,0,291
3832,346,108,2,1,457
3833,343,95,3,1,442
3834,340,109,2,1,452
3835,333,116,2,0,451
3836,293,91,3,0,387
3837,285,91,4,1,381
3838,286,86,4,0,376
3839,252,99,3,2,356
3840,287,88,3,0,378
3841,107,36,0,0,143
3842,216,60,1,1,278
3843,212,60,6,1,279
3844,62,24,2,0,88
3845,276,82,1,2,361
3846,248,82,2,0,332
3847,106,102,3,0,211
3848,98,124,1,0,223
3849,264,169,4,1,438
3850,309,130,4,1,444
3851,233,157,2,1,393
3852,280,141,3,1,425
3853,264,126,3,1,394
3854,253,113,7,0,373
3855,15,13,1,0,29
3856,328,129,5,4,466
3857,308,132,4,2,446
3858,327,104,2,1,434
3859,343,100,4,2,449
3860,399,71,2,0,472
3861,276,37,3,0,316
3862,296,105,4,5,410
3863,297,106,1,0,404
3864,294,124,2,0,420
3865,270,120,4,1,395
3866,279,129,2,1,411
3867,232,108,4,0,344
3868,46,41,1,0,88
3869,81,38,0,0,119
3870,101,60,1,0,162
3871,118,21,0,0,139
3872,149,30,2,0,181
3873,221,119,4,2,346
3874,185,137,0,1,323
3875,212,129,1,0,342
3876,206,123,2,0,331
3877,21,7,1,0,29
3878,104,76,0,0,180
3879,208,32,1,1,242
3880,225,31,2,1,259
3881,221,35,1,2,259
3882,191,49,2,0,242
3883,187,36,3,0,226
3884,135,24,0,0,159
3885,237,35,4,1,277
3886,218,50,1,0,269
3887,79,8,2,0,89
3888,26,9,0,0,35
3889,74,14,0,0,88
3890,219,122,3,0,344
3891,223,123,3,0,349
3892,243,113,1,0,357
3893,193,89,7,0,289
3894,99,95,1,0,195
3895,150,46,3,2,201
3896,72,30,1,0,103
3897,190,197,3,3,393
3898,118,56,0,0,174
3899,195,104,3,0,302
3900,239,90,4,1,334
3901,283,53,3,1,340
3902,251,180,4,0,435
3903,259,105,5,1,370
3904,212,117,0,0,329
3905,184,126,4,0,314
3906,216,75,4,0,295
3907,167,117,2,0,286
3908,184,90,1,1,276
3909,104,74,1,1,180
3910,120,74,2,0,196
3911,16,30,0,0,46
3912,192,87,1,1,281
3913,191,95,2,0,288
3914,216,70,0,0,286
3915,44,39,1,0,84
3916,113,77,2,0,192
3917,343,89,5,0,437
3918,332,98,4,1,435
3919,329,105,1,2,437
3920,336,114,4,0,454
3921,259,109,2,0,370
3922,251,90,2,1,344
3923,260,108,5,0,373
3924,43,88,2,1,134
3925,214,145,6,1,366
3926,264,107,3,1,375
3927,203,134,7,1,345
3928,184,138,2,0,324
3929,205,142,2,0,349
3930,180,139,1,0,320
3931,192,57,4,1,254
3932,132,38,0,1,171
3933,247,155,1,3,406
3934,251,157,6,1,415
3935,240,123,6,0,369
3936,217,142,0,0,359
3937,78,103,6,1,188
3938,78,135,3,1,217
3939,15,116,3,1,135
3940,6,42,8,0,56
3941,10,71,22,1,104
3942,12,147,6,1,166
3943,34,58,3,0,95
3944,8,42,1,0,51
3945,15,131,4,2,152
3946,22,131,5,1,159
3947,4,10,5,2,21
3948,12,33,0,1,46
3949,1,14,0,0,15
3950,366,74,6,2,448
3951,344,85,4,1,434
3952,398,50,6,0,454
3953,296,70,3,2,371
3954,284,70,2,1,357
3955,295,74,3,0,372
3956,183,32,0,1,216
3957,72,27,0,0,99
3958,140,93,1,0,234
3959,88,64,1,1,154
3960,375,59,5,1,440
3961,362,91,3,2,458
3962,332,132,4,3,471
3963,317,125,3,0,445
3964,267,80,2,1,350
3965,255,95,4,0,354
3966,271,81,3,3,358
3967,282,95,2,2,381
3968,409,59,2,2,472
3969,390,34,3,0,427
3970,310,32,1,0,343
3971,42,13,1,0,56
3972,379,74,5,0,458
3973,400,72,2,0,474
3974,376,87,5,0,468
3975,359,93,2,1,455
3976,366,96,3,2,467
3977,352,83,2,2,439
3978,376,105,4,0,485
3979,399,62,6,0,467
3980,430,77,4,2,513
3981,377,72,4,4,457
3982,322,114,8,0,444
3983,368,93,1,2,464
3984,361,99,1,1,462
3985,373,91,0,0,464
3986,370,91,2,2,465
3987,386,88,6,1,481
3988,361,105,2,2,470
3989,359,96,2,0,457
3990,377,70,2,1,450
3991,338,74,2,1,415
3992,329,93,6,3,431
3993,315,76,6,0,397
3994,341,101,1,0,443
3995,308,99,2,2,411
3996,330,96,10,0,436
3997,339,91,3,1,434
3998,277,89,2,0,368
3999,275,77,1,1,354
4000,237,73,7,2,319
4001,380,105,6,1,492
4002,382,93,5,0,480
4003,363,106,4,0,473
4004,382,103,1,0,486
4005,369,112,3,1,485
4006,388,100,5,0,493
4007,389,104,1,1,495
4008,339,106,2,1,448
4009,364,102,2,0,468
4010,307,111,5,1,424
4011,320,103,8,2,433
4012,318,114,7,1,440
4013,325,111,4,3,443
4014,327,127,8,2,464
4015,346,97,9,2,454
4016,347,85,6,2,440
4017,311,88,7,4,410
4018,284,86,5,1,376
4019,315,74,5,1,395
4020,263,87,2,1,353
4021,338,63,3,1,405
4022,286,64,3,0,353
4023,307,77,4,0,388
4024,263,45,4,2,314
4025,328,35,1,0,364
4026,344,63,10,1,418
4027,347,66,2,0,415
4028,336,64,3,1,404
4029,295,60,1,2,358
4030,307,58,6,2,373
4031,342,71,5,1,419
4032,324,99,14,0,437
4033,336,53,2,1,392
4034,11,2,0,0,13
4035,281,51,3,0,335
4036,367,103,4,0,474
4037,384,90,2,0,476
4038,415,68,4,0,487
4039,344,102,6,0,452
4040,400,81,3,0,484
4041,311,114,5,0,430
4042,383,90,2,0,475
4043,368,88,4,1,461
4044,408,72,3,1,484
4045,404,75,6,2,487
4046,390,75,3,1,469
4047,380,82,4,0,466
4048,377,85,3,2,467
4049,369,82,4,1,456
4050,340,102,5,0,447
4051,372,94,7,0,473
4052,363,86,7,0,456
4053,327,99,4,0,430
4054,388,89,2,0,479
4055,379,90,3,0,472
4056,350,109,1,0,460
4057,344,122,3,0,469
4058,373,93,4,0,470
4059,383,88,0,0,471
4060,386,87,1,1,475
4061,376,110,2,0,488
4062,327,117,4,0,448
4063,315,88,1,0,404
4064,324,83,2,1,410
4065,314,73,5,1,393
4066,289,111,3,0,403
4067,248,85,6,0,339
4068,211,47,3,2,263
4069,68,31,0,0,99
4070,58,23,1,0,82
4071,393,57,6,4,460
4072,341,100,4,1,446
4073,349,73,4,1,427
4074,357,71,5,3,436
4075,338,111,4,0,453
4076,336,90,8,4,438
4077,326,70,8,2,406
4078,290,75,2,1,368
4079,276,75,2,3,356
4080,334,108,5,1,448
4081,225,54,4,1,284
4082,270,59,8,2,339
4083,250,64,8,3,325
4084,166,64,1,0,231
4085,268,73,3,1,345
4086,353,82,6,0,441
4087,311,109,1,2,423
4088,321,102,10,1,434
4089,267,82,3,2,354
4090,287,87,4,0,378
4091,249,96,2,2,349
4092,255,62,5,0,322
4093,377,44,7,2,430
4094,369,66,5,1,441
4095,219,39,0,1,259
4096,197,65,3,0,265
4097,68,20,2,0,90
4098,89,65,0,0,154
4099,330,102,5,0,437
4100,297,127,9,2,435
4101,338,124,3,2,467
4102,337,88,6,0,431
4103,321,112,3,4,440
4104,355,109,1,2,467
4105,306,113,2,0,421
4106,353,97,4,1,455
4107,316,112,3,1,432
4108,351,103,4,1,459
4109,301,119,4,0,424
4110,309,129,4,1,443
4111,347,104,4,2,457
4112,348,109,2,0,459
4113,325,91,0,4,420
4114,300,128,3,1,432
4115,300,124,5,2,431
4116,319,127,2,1,449
4117,325,112,3,0,440
4118,306,116,1,0,423
4119,321,110,4,2,437
4120,348,93,4,0,445
4121,310,123,7,0,440
4122,300,130,2,2,434
4123,340,92,6,1,439
4124,332,110,1,0,443
4125,348,127,1,1,477
4126,300,89,1,0,390
4127,289,97,5,1,392
4128,251,94,6,0,351
4129,368,102,2,1,473
4130,329,117,2,0,448
4131,340,121,1,0,462
4132,359,125,4,0,488
4133,340,129,2,0,471
4134,342,103,4,1,450
4135,343,133,3,0,479
4136,333,111,4,1,449
4137,353,113,4,1,471
4138,352,125,2,0,479
4139,348,127,3,0,478
4140,342,108,0,0,450
4141,365,117,2,1,485
4142,342,108,4,0,454
4143,360,107,1,0,468
4144,343,130,1,0,474
4145,315,84,2,0,401
4146,314,84,1,2,401
4147,281,101,2,4,388
4148,364,117,2,1,484
4149,369,110,6,1,486
4150,351,118,4,2,475
4151,383,97,3,0,483
4152,354,122,5,0,481
4153,364,99,3,2,468
4154,362,110,2,1,475
4155,342,114,3,1,460
4156,365,100,2,1,468
4157,346,129,3,0,478
4158,361,103,2,0,466
4159,360,112,3,2,477
4160,352,112,4,2,470
4161,359,101,4,3,467
4162,345,112,4,1,462
4163,374,105,0,1,480
4164,317,87,2,1,407
4165,275,96,3,1,375
4166,296,154,4,0,454
4167,334,133,3,1,471
4168,337,134,3,0,474
4169,328,129,3,0,460
4170,315,124,0,1,440
4171,282,143,1,0,426
4172,296,139,0,2,437
4173,315,137,2,2,456
4174,310,144,2,1,457
4175,289,166,4,1,460
4176,315,137,6,1,459
4177,278,155,3,3,439
4178,332,127,6,1,466
4179,321,141,1,0,463
4180,291,130,4,0,425
4181,272,147,3,0,422
4182,295,137,3,0,435
4183,303,142,1,1,447
4184,301,137,4,1,443
4185,304,148,1,1,454
4186,306,145,1,0,452
4187,284,155,5,1,445
4188,302,147,0,1,450
4189,295,138,7,3,443
4190,314,131,0,1,446
4191,289,144,4,0,437
4192,248,120,4,0,372
4193,288,132,2,1,423
4194,268,155,5,1,429
4195,290,137,6,1,434
4196,318,123,4,0,445
4197,269,164,4,2,439
4198,305,139,2,2,448
4199,254,113,2,1,370
4200,263,101,4,0,368
4201,266,152,2,1,421
4202,253,159,3,0,415
4203,278,160,4,0,442
4204,276,144,2,0,422
4205,205,128,0,0,333
4206,237,111,5,1,354
4207,240,125,4,1,370
4208,228,119,2,0,349
4209,212,110,3,0,325
4210,162,196,3,0,361
4211,135,207,1,0,343
4212,162,177,3,0,342
4213,160,197,3,0,360
4214,160,185,1,0,346
4215,160,171,3,0,334
4216,162,195,1,1,359
4217,150,190,4,0,344
4218,188,191,1,1,381
4219,142,181,7,0,330
4220,176,178,0,2,356
4221,133,195,5,0,333
4222,151,192,3,1,347
4223,141,188,2,1,332
4224,165,201,2,0,368
4225,143,171,2,1,317
4226,133,156,3,0,292
4227,139,145,2,1,287
4228,160,169,3,0,332
4229,289,154,1,1,445
4230,313,134,1,1,449
4231,311,128,2,1,442
4232,257,150,3,0,410
4233,288,133,1,0,422
4234,280,140,2,0,422
4235,273,147,1,0,421
4236,299,147,6,1,453
4237,286,147,4,0,437
4238,238,146,1,0,385
4239,287,121,3,1,412
4240,275,142,6,0,423
4241,275,151,3,0,429
4242,304,137,3,0,444
4243,286,147,5,0,438
4244,283,136,3,0,422
4245,304,134,2,1,441
4246,291,126,5,0,422
4247,289,146,2,1,438
4248,263,160,8,3,434
4249,265,145,3,1,414
4250,275,162,6,2,445
4251,227,133,2,1,363
4252,250,121,4,2,377
4253,235,118,3,0,356
4254,239,116,4,0,359
4255,233,126,2,0,361
4256,286,151,6,0,443
4257,281,162,4,0,447
4258,309,137,2,0,448
4259,295,146,3,1,445
4260,284,141,2,0,427
4261,247,129,5,3,384
4262,270,133,1,2,406
4263,262,127,2,1,392
4264,159,70,4,0,233
4265,55,32,2,0,89
4266,337,129,6,0,472
4267,325,136,4,1,466
4268,297,148,4,2,451
4269,307,147,6,0,460
4270,322,142,3,0,467
4271,364,122,1,1,488
4272,342,117,3,0,462
4273,325,148,5,0,478
4274,349,128,5,2,484
4275,342,127,8,3,480
4276,320,124,2,0,446
4277,347,117,0,0,464
4278,298,136,5,1,440
4279,344,124,4,0,472
4280,309,132,1,0,442
4281,212,153,2,0,367
4282,274,99,5,0,378
4283,305,89,2,2,398
4284,266,117,3,0,386
4285,241,99,4,1,345
4286,266,170,1,1,438
4287,265,169,6,2,442
4288,257,164,4,0,425
4289,293,154,1,1,449
4290,238,154,4,1,397
4291,294,166,0,0,460
4292,318,140,2,2,462
4293,309,160,2,0,471
4294,325,148,3,5,481
4295,317,127,1,0,445
4296,323,139,3,0,465
4297,296,123,4,2,425
4298,309,86,2,0,397
4299,339,72,3,0,414
4300,306,62,0,0,368
4301,353,133,3,1,490
4302,348,136,3,1,488
4303,327,136,8,0,471
4304,320,144,3,1,468
4305,299,123,2,0,424
4306,347,126,4,3,480
4307,316,152,6,2,476
4308,339,131,5,2,477
4309,337,125,7,2,471
4310,331,137,7,1,476
4311,294,96,5,0,395
4312,289,101,1,0,391
4313,286,118,2,0,406
4314,284,105,7,1,397
4315,348,104,0,1,453
4316,280,159,1,1,441
4317,312,145,5,0,462
4318,286,179,3,2,470
4319,256,183,2,1,442
4320,287,133,2,0,422
4321,293,125,5,0,423
4322,39,14,0,0,53
4323,142,39,2,1,184
4324,216,86,0,0,302
4325,5,2,1,0,8
4326,312,131,2,1,446
4327,356,108,3,0,467
4328,355,104,4,0,463
4329,323,121,5,0,449
4330,347,112,2,0,461
4331,312,130,7,0,449
4332,330,113,3,2,448
4333,342,123,2,1,468
4334,327,128,5,1,461
4335,340,110,3,0,453
4336,323,122,3,3,451
4337,283,111,4,0,398
4338,341,116,1,0,458
4339,350,118,5,3,476
4340,338,131,7,1,477
4341,355,124,5,1,485
4342,311,140,6,2,459
4343,341,132,3,1,477
4344,331,110,1,1,443
4345,322,118,1,1,442
4346,277,96,4,3,380
4347,285,148,2,0,435
4348,339,136,2,3,480
4349,298,148,4,0,450
4350,222,145,2,2,371
4351,294,101,6,1,402
4352,247,107,8,0,362
4353,336,134,11,1,482
4354,231,111,3,0,345
4355,203,132,2,1,338
4356,228,119,3,0,350
4357,218,208,3,0,429
4358,252,165,5,0,422
4359,197,156,2,0,355
4360,215,165,5,0,385
4361,318,150,2,1,471
4362,307,146,5,0,458
4363,342,120,2,1,465
4364,303,148,4,0,455
4365,325,140,2,2,469
4366,275,121,3,1,400
4367,278,124,2,0,404
4368,299,151,4,0,454
4369,286,147,4,1,438
4370,280,143,6,1,430
4371,266,151,4,1,422
4372,279,146,5,1,431
4373,265,136,0,0,401
4374,259,126,1,0,386
4375,254,135,3,0,392
4376,242,128,3,1,374
4377,300,121,1,2,424
4378,304,149,7,2,462
4379,285,143,3,1,432
4380,295,108,3,0,406
4381,279,112,1,0,392
4382,335,108,3,0,446
4383,243,124,8,0,375
4384,253,120,1,1,375
4385,243,129,1,1,374
4386,340,87,3,1,431
4387,268,175,2,2,447
4388,255,159,4,0,418
4389,261,177,3,0,441
4390,261,174,4,0,439
4391,266,169,3,0,438
4392,252,175,2,2,431
4393,271,186,3,1,461
4394,288,178,4,1,471
4395,247,125,2,1,375
4396,254,110,1,1,366
4397,215,143,2,0,360
4398,233,150,1,0,384
4399,310,128,3,1,442
4400,268,153,1,0,422
4401,263,152,2,1,418
4402,299,130,2,2,433
4403,316,125,3,2,446
4404,334,129,3,2,468
4405,276,144,4,0,424
4406,305,162,2,2,471
4407,292,163,4,1,460
4408,273,159,4,2,438
4409,322,140,3,1,466
4410,343,110,1,3,457
4411,319,126,2,2,449
4412,269,122,3,2,396
4413,284,160,4,2,450
4414,289,152,6,2,449
4415,271,155,7,0,433
4416,249,129,1,1,380
4417,247,138,4,2,391
4418,265,169,4,0,438
4419,269,150,2,1,422
4420,253,173,0,0,426
4421,205,137,1,1,344
4422,229,124,0,1,354
4423,231,136,2,0,369
4424,208,142,3,1,354
4425,240,112,0,1,353
4426,268,123,3,0,394
4427,375,91,2,0,468
4428,58,21,0,0,79
4429,254,123,4,2,383
4430,215,126,2,1,344
4431,317,124,2,1,444
4432,259,99,0,1,359
4433,252,118,3,0,373
4434,255,150,5,0,410
4435,300,147,3,0,450
4436,300,121,4,0,425
4437,345,111,6,0,462
4438,309,139,4,0,452
4439,322,149,2,0,473
4440,320,131,1,1,453
4441,336,115,5,1,457
4442,327,117,5,1,450
4443,292,129,3,1,425
4444,302,127,1,0,430
4445,294,139,4,0,437
4446,289,136,2,0,427
4447,287,111,4,0,402
4448,262,139,8,1,410
4449,295,103,3,0,401
4450,310,102,3,1,416
4451,261,154,4,1,420
4452,274,135,3,0,412
4453,289,144,6,0,439
4454,282,126,3,0,411
4455,246,139,5,1,391
4456,270,136,2,2,410
4457,263,145,5,0,413
4458,284,130,3,0,417
4459,283,126,3,1,413
4460,279,145,5,0,429
4461,281,141,6,2,430
4462,300,118,7,0,425
4463,276,119,4,0,399
4464,294,145,3,0,442
4465,289,142,2,1,434
4466,329,136,1,0,466
4467,230,147,2,0,379
4468,237,123,1,0,361
4469,270,103,2,0,375
4470,286,100,2,0,388
4471,294,140,3,0,437
4472,270,121,3,0,394
4473,298,108,1,1,408
4474,241,114,2,0,357
4475,330,135,4,1,470
4476,341,122,3,2,468
4477,337,108,3,2,450
4478,268,101,6,0,375
4479,287,109,1,0,397
4480,265,126,6,2,399
4481,282,96,1,2,381
4482,267,113,5,0,385
4483,242,124,2,1,369
4484,227,138,2,0,367
4485,208,123,3,0,334
4486,200,146,5,1,352
4487,218,143,3,0,364
4488,302,110,6,0,418
4489,220,114,1,0,335
4490,234,89,4,0,327
4491,200,116,1,0,317
4492,236,105,1,0,342
4493,323,110,2,1,436
4494,349,110,8,2,469
4495,274,101,1,0,376
4496,256,92,7,0,355
4497,296,82,1,1,380
4498,277,79,4,0,360
4499,307,134,4,1,446
4500,321,123,1,0,445
4501,306,135,3,1,445
4502,329,131,4,1,465
4503,315,126,5,2,448
4504,341,114,6,2,463
4505,295,137,1,0,433
4506,314,127,4,1,446
4507,327,143,1,3,474
4508,272,98,7,1,378
4509,256,99,3,2,360
4510,276,98,3,1,378
4511,293,95,3,2,393
4512,333,93,1,1,428
4513,349,100,2,0,451
4514,252,114,2,2,370
4515,257,104,3,1,365
4516,278,107,5,0,390
4517,251,113,3,0,367
4518,294,85,3,0,382
4519,229,95,4,1,329
4520,228,94,3,1,326
4521,16,7,0,0,23
4522,23,9,0,2,34
4523,263,74,2,0,339
4524,261,85,3,3,352
4525,239,72,4,1,316
4526,185,65,8,0,258
4527,174,69,3,0,246
4528,260,93,1,0,354
4529,243,89,1,2,335
4530,246,95,4,1,346
4531,258,70,4,1,333
4532,365,92,4,0,461
4533,351,100,3,1,455
4534,341,99,1,0,441
4535,345,104,3,1,453
4536,336,104,0,2,442
4537,386,79,2,0,467
4538,318,92,5,2,417
4539,317,109,1,1,428
4540,355,100,2,1,458
4541,339,109,3,1,452
4542,312,73,1,0,386
4543,296,77,0,0,373
4544,286,86,2,0,374
4545,348,51,2,0,401
4546,349,88,1,1,439
4547,333,114,4,0,451
4548,320,138,4,1,463
4549,364,91,2,0,457
4550,347,111,3,0,461
4551,362,119,4,1,486
4552,309,124,3,0,436
4553,315,121,4,1,441
4554,338,112,3,2,455
4555,281,96,2,1,380
4556,271,86,2,1,360
4557,324,102,4,2,432
4558,316,126,6,2,450
4559,347,123,2,1,473
4560,364,106,7,0,477
4561,277,100,8,0,385
4562,261,120,4,1,386
4563,272,111,4,0,387
4564,345,82,3,1,431
4565,353,104,6,1,464
4566,359,123,6,1,489
4567,348,107,4,1,460
4568,355,103,6,1,465
4569,336,123,4,2,465
4570,356,119,6,0,481
4571,310,122,10,0,442
4572,312,126,1,0,439
4573,321,131,4,2,458
4574,353,114,4,3,474
4575,345,117,3,2,467
4576,279,102,2,1,384
4577,283,99,3,2,387
4578,294,83,11,0,388
4579,326,83,2,0,411
4580,348,149,4,1,502
4581,376,104,1,1,482
4582,290,98,3,0,391
4583,315,95,3,1,414
4584,318,86,1,0,405
4585,262,163,4,0,429
4586,301,130,4,0,435
4587,289,139,3,2,433
4588,329,128,3,0,460
4589,252,168,2,0,422
4590,306,148,2,1,457
4591,300,153,2,1,456
4592,304,146,5,0,455
4593,315,106,5,0,426
4594,311,135,4,1,451
4595,319,136,2,0,457
4596,326,138,2,0,466
4597,320,115,3,2,440
4598,321,125,1,1,448
4599,314,146,2,0,462
4600,311,122,4,0,437
4601,300,139,4,1,444
4602,304,143,5,0,452
4603,320,110,1,0,431
4604,312,130,2,0,444
4605,333,121,2,2,458
4606,296,141,2,1,440
4607,306,118,3,0,427
4608,317,122,3,1,443
4609,284,175,4,0,463
4610,335,112,2,1,450
4611,318,144,4,1,467
4612,323,135,2,2,462
4613,293,162,2,1,458
4614,334,135,3,0,472
4615,313,151,5,1,470
4616,329,139,3,0,471
4617,316,141,2,0,459
4618,345,100,3,1,449
4619,238,122,2,2,364
4620,291,91,4,0,386
4621,266,98,2,0,366
4622,231,145,1,1,378
4623,216,123,0,0,339
4624,199,137,4,1,341
4625,230,150,0,0,380
4626,326,124,6,0,456
4627,317,135,1,0,453
4628,326,137,2,1,466
4629,317,141,1,0,459
4630,263,119,1,1,384
4631,294,119,3,1,417
4632,20,20,0,0,40
4633,138,166,6,1,311
4634,146,157,1,3,307
4635,149,155,1,0,305
4636,141,171,0,0,312
4637,120,132,4,3,259
4638,7,5,0,0,12
4639,19,14,0,0,33
4640,111,159,4,0,274
4641,90,178,3,0,271
4642,103,162,5,2,272
4643,86,167,4,0,257
4644,64,157,2,1,224
4645,43,34,2,0,79
4646,58,123,4,0,185
4647,44,120,1,1,166
4648,87,171,3,2,263
4649,71,162,2,2,237
4650,66,158,1,2,227
4651,91,208,1,1,301
4652,109,175,2,1,287
4653,110,185,2,4,301
4654,142,170,3,0,315
4655,68,56,1,0,125
4656,68,146,3,1,218
4657,58,162,2,0,222
4658,178,170,6,2,356
4659,191,195,6,1,393
4660,183,205,3,0,391
4661,161,161,4,0,326
4662,148,186,1,1,336
4663,155,190,2,0,347
4664,55,61,2,3,121
4665,56,52,0,0,108
4666,174,134,4,1,313
4667,47,33,1,0,81
4668,95,264,3,2,364
4669,115,94,1,2,212
4670,94,93,1,1,189
4671,23,23,0,0,46
4672,14,16,0,0,30
4673,37,86,2,0,125
4674,8,4,1,0,13
4675,124,244,4,1,373
4676,112,184,4,0,300
4677,115,173,3,0,291
4678,128,183,3,1,315
4679,130,170,2,1,303
4680,117,265,4,2,388
4681,153,222,0,1,376
4682,126,223,4,0,353
4683,159,217,5,2,383
4684,140,205,2,0,347
4685,144,226,1,1,372
4686,74,196,3,1,274
4687,90,163,2,1,256
4688,96,241,1,3,341
4689,147,212,1,0,360
4690,145,196,5,0,346
4691,115,233,2,1,351
4692,136,227,3,1,367
4693,106,147,1,0,254
4694,8,52,2,0,62
4695,169,220,3,1,393
4696,172,207,4,0,383
4697,161,214,4,0,379
4698,138,222,5,1,366
4699,31,77,1,0,109
4700,167,220,4,0,391
4701,92,138,1,0,231
4702,81,165,3,0,249
4703,58,171,0,0,229
4704,61,129,2,2,194
4705,103,209,3,0,315
4706,136,178,4,1,319
4707,27,94,0,1,122
4708,83,96,1,1,181
4709,69,101,1,0,171
4710,55,25,2,0,82
4711,19,48,0,0,67
4712,243,135,3,1,382
4713,270,113,2,0,385
4714,254,127,4,0,385
4715,245,135,4,0,384
4716,249,131,1,0,381
4717,270,113,5,1,389
4718,204,116,0,0,320
4719,211,109,1,0,321
4720,218,107,2,1,328
4721,214,115,2,0,331
4722,201,115,2,0,318
4723,270,115,5,0,390
4724,107,92,1,0,200
4725,110,85,2,0,197
4726,69,69,3,0,141
4727,4,15,0,0,19
4728,152,110,3,0,265
4729,141,117,0,0,258
4730,121,118,1,0,240
4731,150,171,3,0,324
4732,131,159,4,0,294
4733,113,158,1,0,272
4734,168,130,4,0,302
4735,144,154,2,0,300
4736,111,183,3,0,297
4737,119,116,3,0,238
4738,113,147,3,0,263
4739,118,151,4,0,273
4740,257,121,1,1,380
4741,248,134,2,0,384
4742,250,129,0,0,379
4743,246,120,0,1,367
4744,272,117,1,1,391
4745,184,122,2,0,308
4746,201,112,1,0,314
4747,226,90,1,0,317
4748,202,128,0,1,331
4749,252,134,2,0,388
4750,152,169,3,0,324
4751,159,176,4,1,340
4752,139,161,4,0,304
4753,148,175,5,1,329
4754,139,179,4,0,322
4755,123,190,5,1,319
4756,170,163,2,0,335
4757,191,139,4,0,334
4758,173,163,1,1,338
4759,139,166,1,1,307
4760,160,145,4,1,310
4761,154,170,6,0,330
4762,132,174,4,0,310
4763,135,138,2,0,275
4764,132,141,4,1,278
4765,123,161,4,0,288
4766,133,126,0,1,260
4767,140,158,1,0,299
4768,175,160,1,1,337
4769,7,19,0,0,26
4770,70,48,0,0,118
4771,243,144,0,0,387
4772,226,153,2,1,382
4773,233,119,2,0,354
4774,235,132,1,0,368
4775,198,109,6,0,313
4776,226,123,3,0,352
4777,197,126,4,0,327
4778,191,135,1,1,328
4779,228,151,3,0,382
4780,39,66,5,0,110
4781,250,123,2,1,376
4782,255,99,1,1,356
4783,213,134,1,0,348
4784,21,29,0,0,50
4785,231,159,2,2,394
4786,194,208,0,0,402
4787,98,174,1,1,274
4788,130,88,2,0,220
4789,21,52,1,0,74
4790,130,163,5,1,299
4791,95,161,5,0,261
4792,186,101,0,0,287
4793,170,105,2,0,277
4794,155,126,0,1,282
4795,78,147,1,0,226
4796,167,106,4,0,277
4797,137,124,4,0,265
4798,75,121,1,0,197
4799,311,119,0,0,430
4800,298,133,0,0,431
4801,266,148,1,0,415
4802,287,104,0,0,391
4803,283,136,3,0,422
4804,311,110,2,1,424
4805,299,132,3,1,435
4806,291,107,1,0,399
4807,282,117,3,1,403
4808,310,104,2,0,416
4809,293,124,6,1,424
4810,280,97,0,0,377
4811,257,105,3,1,366
4812,268,115,2,2,387
4813,144,99,4,0,247
4814,204,107,10,2,323
4815,91,96,2,0,189
4816,209,150,5,0,364
4817,220,154,4,0,378
4818,211,137,4,2,354
4819,238,126,2,0,366
4820,192,117,6,1,316
4821,197,148,4,0,349
4822,208,131,5,1,345
4823,202,105,2,1,310
4824,192,141,2,0,335
4825,160,80,8,0,248
4826,142,144,11,0,297
4827,149,118,3,0,270
4828,89,122,3,0,214
4829,59,123,1,0,183
4830,42,19,2,0,63
4831,76,44,2,0,122
4832,162,120,6,1,289
4833,43,61,0,0,104
4834,156,130,2,0,288
4835,147,132,4,1,284
4836,178,99,1,1,279
4837,214,69,7,2,292
4838,19,12,0,0,31
4839,160,97,3,0,260
4840,245,126,6,0,377
4841,39,22,0,1,62
4842,15,6,0,0,21
4843,114,63,0,0,177
4844,76,95,0,1,172
4845,79,91,2,0,172
4846,212,99,0,0,311
4847,200,107,0,0,307
4848,203,72,3,3,281
4849,28,15,1,0,44
4850,115,159,7,0,281
4851,210,106,1,1,318
4852,78,70,2,2,152
4853,178,105,1,0,284
4854,53,62,2,1,118
4855,71,73,2,1,147
4856,103,117,1,0,221
4857,87,119,0,1,207
4858,148,107,5,0,260
4859,129,91,1,1,222
4860,61,40,1,2,104
4861,116,113,7,0,236
4862,153,152,5,0,310
4863,113,69,2,0,184
4864,221,84,0,1,306
4865,47,48,2,1,98
4866,87,117,4,2,210
4867,252,186,4,1,443
4868,73,61,4,0,138
4869,15,53,1,0,69
4870,140,57,3,0,200
4871,49,26,1,0,76
4872,27,37,0,0,64
4873,104,48,1,1,154
4874,161,233,0,1,395
4875,186,70,2,0,258
4876,58,32,2,1,93
4877,116,78,0,0,194
4878,94,187,4,1,286
4879,94,78,3,1,176
4880,143,66,4,2,215
4881,148,76,3,0,227
4882,137,98,3,0,238
4883,127,87,3,1,218
4884,83,103,5,0,191
4885,27,19,1,0,47
4886,47,22,0,0,69
4887,148,157,5,0,310
4888,132,97,3,0,232
4889,127,113,7,0,247
4890,128,118,7,0,253
4891,109,112,3,0,224
4892,9,16,0,0,25
4893,84,63,2,0,149
4894,144,113,5,0,262
4895,61,51,0,1,113
4896,65,40,2,0,107
4897,86,47,1,0,134
4898,80,39,3,0,122
4899,95,33,2,2,132
4900,202,82,4,2,290
4901,194,60,6,2,262
4902,66,70,3,0,139
4903,11,24,1,0,36
4904,29,23,2,0,54
4905,242,125,1,0,368
4906,257,133,4,0,394
4907,274,109,3,0,386
4908,264,125,4,0,393
4909,251,128,1,0,380
4910,198,143,4,0,345
4911,275,117,2,1,395
4912,230,104,6,0,340
4913,240,133,2,0,375
4914,240,135,3,0,378
4915,239,119,4,0,362
4916,200,128,3,0,331
4917,227,127,5,0,359
4918,191,119,2,0,312
4919,248,100,0,0,348
4920,243,100,0,0,343
4921,218,104,1,1,324
4922,195,122,2,0,319
4923,235,107,2,0,344
4924,229,98,2,0,329
4925,182,89,1,0,272
4926,210,75,1,0,286
4927,187,67,3,1,258
4928,181,74,3,0,258
4929,198,90,5,0,293
4930,130,93,3,0,226
4931,110,97,1,0,208
4932,212,131,2,1,346
4933,115,54,1,1,171
4934,121,51,3,0,175
4935,6,18,2,0,26
4936,145,61,2,0,208
4937,155,61,3,1,220
4938,179,68,2,1,250
4939,4,1,0,0,5
4940,168,112,3,0,283
4941,124,102,1,0,227
4942,135,129,4,1,269
4943,103,139,2,1,245
4944,158,136,8,0,302
4945,139,153,4,0,296
4946,152,97,2,0,251
4947,142,77,6,0,225
4948,166,82,4,0,252
4949,122,114,1,1,238
4950,124,89,1,0,214
4951,111,114,1,0,226
4952,110,79,1,1,191
4953,102,72,9,1,184
4954,37,43,2,2,84
4955,20,27,2,1,50
4956,140,70,4,0,214
4957,118,96,3,0,217
4958,130,95,3,1,229
4959,165,77,3,1,246
4960,98,122,2,0,222
4961,119,108,4,1,232
4962,186,90,3,1,280
4963,145,78,1,0,224
4964,148,93,1,0,242
4965,256,93,4,0,353
4966,259,80,4,0,343
4967,196,102,4,0,302
4968,171,113,5,0,289
4969,202,79,2,1,284
4970,89,112,2,0,203
4971,74,103,3,0,180
4972,58,71,3,0,132
4973,60,158,2,3,223
4974,66,21,2,1,90
4975,14,9,0,0,23
4976,10,11,0,0,21
4977,220,78,2,0,300
4978,212,91,5,0,308
4979,231,83,4,0,318
4980,194,83,4,0,281
4981,169,56,1,0,226
4982,72,75,4,0,151
4983,167,124,8,0,299
4984,168,97,5,0,270
4985,168,113,7,0,288
4986,166,83,0,0,249
4987,124,86,5,0,215
4988,122,82,1,2,207
4989,196,106,4,1,307
4990,175,121,1,0,297
4991,197,110,4,2,313
4992,223,92,9,1,325
4993,139,74,8,1,222
4994,138,70,2,2,212
4995,145,75,5,0,225
4996,151,134,2,0,287
4997,183,170,0,0,353
4998,198,118,0,0,316
4999,186,127,0,1,314
5000,194,107,5,0,306
5001,187,115,0,0,302
5002,189,109,0,0,298
5003,181,145,0,0,326
5004,233,128,3,0,364
5005,180,122,4,1,307
5006,61,53,0,0,114
5007,32,63,3,0,98
5008,49,20,1,0,70
5009,69,93,4,0,166
5010,118,77,0,0,195
5011,105,141,1,0,247
5012,109,167,3,0,279
5013,68,38,2,0,108
5014,65,84,2,0,151
5015,63,59,1,0,123
5016,47,8,0,0,55
5017,217,175,0,0,392
5018,219,168,2,1,390
5019,226,130,3,1,360
5020,123,107,4,1,235
5021,239,179,2,1,421
5022,264,152,1,1,418
5023,241,148,2,4,395
5024,249,151,8,0,408
5025,65,31,1,0,97
5026,29,23,1,0,53
5027,155,228,3,1,387
5028,52,61,4,0,117
5029,241,104,3,0,348
5030,217,108,3,1,329
5031,212,112,4,0,328
5032,244,81,3,2,330
5033,218,89,3,1,311
5034,215,104,1,0,320
5035,241,107,3,0,351
5036,198,129,5,0,332
5037,198,89,2,0,289
5038,36,90,4,0,130
5039,94,219,6,1,320
5040,212,164,2,0,378
5041,188,132,3,0,323
5042,149,145,2,1,297
5043,180,127,1,0,308
5044,211,93,6,0,310
5045,211,94,1,0,306
5046,221,125,4,0,350
5047,160,163,1,1,325
5048,207,160,5,0,372
5049,178,131,3,0,312
5050,197,136,2,1,336
5051,196,141,3,1,341
5052,152,86,1,0,239
5053,141,132,2,1,276
5054,117,224,1,1,343
5055,182,122,2,0,306
5056,128,193,2,0,323
5057,144,141,4,1,290
5058,149,161,2,0,312
5059,143,167,0,0,310
5060,126,81,4,2,213
5061,60,39,0,0,99
5062,91,91,2,1,185
5063,123,102,2,1,228
5064,5,4,0,0,9
5065,153,164,3,0,320
5066,160,154,1,1,316
5067,145,166,1,0,312
5068,152,165,5,0,322
5069,155,157,1,0,313
5070,153,110,8,1,272
5071,143,120,8,0,271
5072,136,101,2,0,239
5073,93,46,0,0,139
5074,138,248,0,0,386
5075,74,57,1,0,132
5076,89,84,1,0,174
5077,234,131,3,1,369
5078,173,154,2,1,330
5079,208,151,4,1,364
5080,188,141,2,0,331
5081,245,127,0,0,372
5082,225,138,1,0,364
5083,202,144,3,0,349
5084,208,152,2,0,362
5085,187,174,2,3,366
5086,189,170,1,0,360
5087,206,155,2,1,364
5088,209,148,2,0,359
5089,78,167,3,1,249
5090,140,104,6,2,252
5091,31,24,0,0,55
5092,130,83,1,0,214
5093,193,160,8,0,361
5094,162,157,3,0,322
5095,171,145,0,1,317
5096,181,125,3,1,310
5097,208,170,0,0,378
5098,186,180,2,1,369
5099,194,152,5,0,351
5100,198,151,2,0,351
5101,185,171,0,0,356
5102,194,158,3,3,358
5103,15,4,2,0,21
5104,67,156,2,0,225
5105,49,202,4,1,256
5106,49,155,0,1,205
5107,65,140,0,0,205
5108,138,68,2,0,208
5109,44,27,1,0,72
5110,121,95,3,0,219
5111,105,116,0,0,221
5112,90,66,2,0,158
5113,31,4,1,0,36
5114,62,140,4,0,206
5115,54,154,4,1,213
5116,76,136,0,0,212
5117,96,82,2,0,180
5118,47,30,0,1,78
5119,211,144,0,0,355
5120,239,127,0,3,369
5121,204,123,2,2,331
5122,230,119,4,0,353
5123,187,140,4,0,331
5124,215,129,6,1,351
5125,185,146,5,0,336
5126,198,136,3,0,337
5127,217,140,2,0,359
5128,32,24,1,1,58
5129,74,116,4,1,195
5130,61,124,3,0,188
5131,142,166,4,1,313
5132,130,166,3,2,301
5133,50,35,1,0,86
5134,19,9,0,0,28
5135,12,5,0,0,17
5136,99,47,3,2,151
5137,49,15,0,0,64
5138,81,57,0,0,138
5139,81,36,1,1,119
5140,122,110,2,0,234
5141,149,59,1,0,209
5142,77,35,1,0,113
5143,136,130,0,0,266
5144,161,76,0,1,238
5145,21,5,0,0,26
5146,188,99,4,0,291
5147,132,90,3,0,225
5148,131,97,2,0,230
5149,154,126,4,0,284
5150,94,112,3,1,210
5151,127,113,1,0,241
5152,86,92,4,1,183
5153,93,89,7,0,189
5154,14,27,1,0,42
5155,47,28,0,0,75
5156,61,71,1,1,134
5157,74,123,2,0,199
5158,279,138,0,0,417
5159,223,170,2,1,396
5160,249,174,1,0,424
5161,250,167,4,0,421
5162,277,151,0,0,428
5163,212,169,8,0,389
5164,248,148,6,0,402
5165,247,167,1,0,415
5166,217,123,3,1,344
5167,235,126,4,0,365
5168,231,123,3,0,357
5169,212,146,4,1,363
5170,24,30,0,0,54
5171,114,90,0,0,204
5172,9,8,1,0,18
5173,231,150,3,0,384
5174,81,83,2,1,167
5175,167,235,2,0,404
5176,56,42,0,0,98
5177,101,68,0,0,169
5178,67,49,0,0,116
5179,255,153,1,1,410
5180,243,176,2,1,422
5181,9,21,0,0,30
5182,70,22,0,1,93
5183,208,113,4,0,325
5184,228,116,0,1,345
5185,144,87,1,0,232
5186,165,32,0,0,197
5187,47,21,1,0,69
5188,107,21,0,1,129
5189,18,13,0,0,31
5190,252,137,3,1,393
5191,86,121,4,0,211
5192,169,138,0,0,307
5193,196,116,4,0,316
5194,247,136,1,1,385
5195,13,11,1,0,25
5196,221,115,2,2,340
5197,266,76,0,1,343
5198,251,83,6,0,340
5199,246,98,1,0,345
5200,9,4,0,0,13
5201,221,67,0,2,290
5202,233,106,1,1,341
5203,35,26,0,0,61
5204,79,174,4,2,259
5205,118,21,2,0,141
5206,89,35,5,0,129
5207,64,20,2,0,86
5208,69,33,0,0,102
5209,75,18,0,0,93
5210,145,219,7,0,371
5211,162,179,5,0,346
5212,109,152,2,0,263
5213,42,16,0,0,58
5214,68,11,0,0,79
5215,170,69,2,0,241
5216,61,36,0,0,97
5217,76,77,2,0,155
5218,72,30,3,1,106
5219,92,39,2,0,133
5220,168,137,3,4,312
5221,71,60,2,0,133
5222,35,28,0,1,64
5223,68,28,2,1,99
5224,81,40,2,0,123
5225,18,106,2,0,126
5226,177,130,1,0,308
5227,195,104,3,0,302
5228,170,117,4,1,292
5229,190,100,3,0,293
5230,167,119,2,0,288
5231,184,120,0,0,304
5232,162,111,1,0,274
5233,183,109,1,1,294
5234,146,159,3,1,309
5235,71,67,1,1,140
5236,45,70,1,1,117
5237,31,47,1,0,79
5238,56,14,0,0,70
5239,52,154,1,0,207
5240,91,94,3,0,188
5241,91,91,1,0,183
5242,72,166,4,1,243
5243,80,163,0,1,244
5244,61,140,2,2,205
5245,66,128,2,0,196
5246,93,202,1,1,297
5247,8,39,0,0,47
5248,15,79,0,0,94
5249,53,161,4,0,218
5250,21,35,0,0,56
5251,28,74,2,1,105
5252,162,108,3,1,274
5253,43,56,1,0,100
5254,9,17,0,1,27
5255,69,141,2,0,212
5256,56,154,0,0,210
5257,66,139,0,0,205
5258,342,104,2,0,448
5259,333,87,1,0,421
5260,335,81,2,0,418
5261,314,89,1,0,404
5262,156,13,1,0,170
5263,102,60,1,0,163
5264,101,102,4,2,209
5265,124,116,1,0,241
5266,64,23,1,0,88
5267,54,30,1,2,87
5268,197,35,3,1,236
5269,40,42,0,0,82
5270,82,15,0,0,97
5271,30,27,1,0,58
5272,131,19,3,0,153
5273,100,165,6,1,272
5274,141,62,4,0,207
5275,86,22,1,0,109
5276,190,29,1,1,221
5277,260,116,3,1,380
5278,255,120,7,1,383
5279,262,135,2,1,400
5280,267,105,0,2,374
5281,7,83,1,0,91
5282,252,130,2,1,385
5283,214,122,1,0,337
5284,237,122,4,0,363
5285,216,129,3,0,348
5286,236,104,2,0,342
5287,208,132,0,0,340
5288,201,122,4,0,327
5289,199,111,4,0,314
5290,224,98,3,2,327
5291,181,94,1,1,277
5292,108,139,2,0,249
5293,113,226,3,0,342
5294,18,27,0,0,45
5295,61,74,2,0,137
5296,98,96,1,1,196
5297,93,79,4,0,176
5298,70,72,4,0,146
5299,36,99,2,0,137
5300,50,84,3,1,138
5301,52,49,2,1,104
5302,112,91,1,1,205
5303,96,119,4,0,219
5304,45,176,1,0,222
5305,51,190,2,0,243
5306,160,107,3,0,270
5307,152,96,3,1,252
5308,132,100,0,0,232
5309,227,135,2,0,364
5310,187,131,2,1,321
5311,223,120,4,0,347
5312,214,138,3,0,355
5313,88,84,1,0,173
5314,101,71,1,0,173
5315,47,13,1,0,61
5316,29,22,0,0,51
5317,23,2,0,0,25
5318,136,48,3,0,187
5319,126,61,3,0,190
5320,151,142,2,0,295
5321,41,6,1,0,48
5322,152,77,2,0,231
5323,61,5,0,1,67
5324,95,34,3,1,133
5325,16,8,0,2,26
5326,176,108,2,2,288
5327,37,198,1,0,236
5328,85,32,3,1,121
5329,151,38,1,0,190
5330,52,108,2,0,162
5331,18,2,0,0,20
5332,155,184,2,1,342
5333,127,220,4,1,352
5334,133,187,2,0,322
5335,125,156,2,1,284
5336,54,60,1,0,115
5337,54,30,0,0,84
5338,117,102,0,0,219
5339,107,112,1,0,220
5340,80,77,2,0,159
5341,27,7,0,0,34
5342,46,28,2,0,76
5343,30,39,2,0,71
5344,40,106,0,0,146
5345,51,44,2,0,97
5346,48,125,2,0,175
5347,31,53,0,0,84
5348,79,165,8,0,252
5349,56,194,5,0,255
5350,58,188,6,1,253
5351,59,185,4,1,249
5352,27,106,1,1,135
5353,78,45,3,0,126
5354,205,123,7,2,337
5355,44,31,3,1,79
5356,148,199,2,2,351
5357,120,209,2,0,331
5358,130,209,1,1,341
5359,149,188,3,1,341
5360,95,230,1,0,326
5361,130,189,1,0,320
5362,124,213,3,0,340
5363,130,195,3,1,329
5364,125,189,2,0,316
5365,118,224,3,0,345
5366,140,204,2,1,347
5367,140,208,1,0,349
5368,134,199,0,0,333
5369,138,203,1,0,342
5370,127,173,4,0,304
5371,123,186,1,0,310
5372,111,185,3,0,299
5373,213,187,2,0,402
5374,85,134,2,1,222
5375,136,149,1,0,286
5376,115,166,3,0,284
5377,132,149,3,0,284
5378,135,195,2,0,332
5379,111,127,1,0,239
5380,89,201,5,0,295
5381,98,188,4,0,290
5382,114,200,2,0,316
5383,112,188,0,1,301
5384,122,187,2,1,312
5385,85,220,3,0,308
5386,90,174,3,0,267
5387,129,198,2,0,329
5388,136,187,4,4,331
5389,106,191,3,0,300
5390,101,222,3,0,326
5391,89,217,5,2,313
5392,116,242,1,0,359
5393,145,174,2,0,321
5394,136,200,1,0,337
5395,5,13,0,1,19
5396,323,86,1,0,410
5397,243,149,0,1,393
5398,244,150,1,1,396
5399,280,137,3,2,422
5400,252,86,1,1,340
5401,163,67,1,1,232
5402,3,1,0,0,4
5403,79,138,1,0,218
5404,108,155,0,0,263
5405,104,153,5,0,262
5406,104,153,2,0,259
5407,121,157,2,0,280
5408,108,188,4,0,300
5409,125,60,3,0,188
5410,68,67,0,0,135
5411,42,98,2,0,142
5412,17,20,0,0,37
5413,34,68,0,0,102
5414,24,42,0,1,67
5415,99,87,1,1,188
5416,91,48,1,0,140
5417,145,147,4,0,296
5418,159,172,4,0,335
5419,164,167,2,1,334
5420,165,200,1,0,366
5421,153,188,1,2,344
5422,154,194,6,0,354
5423,162,177,2,0,341
5424,155,185,1,0,341
5425,169,172,4,0,345
5426,122,207,1,0,330
5427,121,160,2,0,283
5428,156,169,4,0,329
5429,143,165,4,0,312
5430,66,213,3,1,283
5431,87,203,3,0,293
5432,80,235,2,1,318
5433,77,212,2,0,291
5434,72,222,1,0,295
5435,83,188,2,0,273
5436,83,192,2,2,279
5437,60,194,3,0,257
5438,88,175,1,0,264
5439,75,185,1,0,261
5440,117,153,2,0,272
5441,16,234,1,1,252
5442,47,168,2,0,217
5443,159,139,2,0,300
5444,136,131,4,1,272
5445,18,7,0,0,25
5446,241,170,3,1,415
5447,237,174,3,1,415
5448,241,185,2,0,428
5449,244,175,2,0,421
5450,209,177,2,1,389
5451,235,164,5,0,404
5452,244,174,2,3,423
5453,236,130,2,0,368
5454,223,151,4,0,378
5455,204,159,1,2,366
5456,233,132,3,0,368
5457,217,123,2,0,342
5458,38,53,2,0,93
5459,30,68,1,1,100
5460,116,200,1,0,317
5461,101,208,3,0,312
5462,122,187,3,1,313
5463,114,179,2,0,295
5464,117,150,1,1,269
5465,120,165,2,0,287
5466,112,173,2,1,288
5467,15,12,2,0,29
5468,58,39,1,0,98
5469,79,57,0,1,137
5470,53,80,1,0,134
5471,254,155,3,0,412
5472,215,185,0,0,400
5473,231,179,1,1,412
5474,207,177,2,1,387
5475,221,178,3,0,402
5476,245,159,2,1,407
5477,228,177,3,0,408
5478,185,204,4,1,394
5479,242,160,3,0,405
5480,229,163,3,0,395
5481,207,180,2,1,390
5482,265,166,2,0,433
5483,221,164,1,2,388
5484,221,148,2,1,372
5485,213,186,6,0,405
5486,125,168,4,1,298
5487,129,150,1,0,280
5488,118,144,1,0,263
5489,113,154,1,0,268
5490,225,165,9,1,400
5491,228,152,0,2,382
5492,186,194,6,0,386
5493,195,192,6,1,394
5494,208,165,5,6,384
5495,114,201,6,0,321
5496,132,208,3,0,343
5497,104,186,4,0,294
5498,144,114,0,1,259
5499,149,130,1,0,280
5500,7,4,1,1,13
5501,183,180,2,1,366
5502,169,193,4,1,367
5503,184,181,3,1,369
5504,155,209,5,0,369
5505,176,176,1,1,354
5506,54,87,8,0,149
5507,155,130,2,0,287
5508,87,18,0,0,105
5509,184,140,3,1,328
5510,56,19,1,1,77
5511,17,24,0,0,41
5512,82,151,1,0,234
5513,48,37,1,0,86
5514,29,24,1,0,54
5515,93,216,9,0,318
5516,92,213,2,0,307
5517,65,197,1,1,264
5518,17,56,0,0,73
5519,149,184,9,1,343
5520,158,182,1,0,341
5521,136,175,4,1,316
5522,127,203,8,1,339
5523,165,159,3,0,327
5524,170,191,2,2,365
5525,148,185,3,1,337
5526,155,176,5,1,337
5527,124,204,3,3,334
5528,138,186,4,1,329
5529,117,196,4,0,317
5530,184,185,10,0,379
5531,27,117,0,1,145
5532,104,121,8,1,234
5533,63,154,3,0,220
5534,70,114,4,1,189
5535,13,75,1,0,89
5536,35,148,2,0,185
5537,38,129,2,0,169
5538,76,128,5,1,210
5539,23,6,0,0,29
5540,11,75,0,1,87
5541,30,67,1,0,98
5542,65,150,2,0,217
5543,49,140,4,2,195
5544,58,132,6,0,196
5545,98,211,5,0,314
5546,86,227,7,4,324
5547,107,231,3,0,341
5548,75,211,3,1,290
5549,108,208,2,3,321
5550,80,200,6,1,287
5551,24,29,0,1,54
5552,124,195,1,1,321
5553,130,200,10,0,340
5554,110,229,7,0,346
5555,69,119,2,0,190
5556,101,171,0,0,272
5557,82,172,1,2,257
5558,80,162,2,1,245
5559,100,94,2,2,198
5560,54,88,3,2,147
5561,50,182,2,0,234
5562,124,234,6,4,368
5563,39,160,4,0,203
5564,49,170,0,0,219
5565,14,15,1,0,30
5566,27,144,2,0,173
5567,35,97,2,2,136
5568,225,100,1,0,326
5569,201,121,6,1,329
5570,124,102,0,0,226
5571,32,47,0,1,80
5572,23,61,0,0,84
5573,27,25,3,0,55
5574,136,110,0,1,247
5575,34,175,0,0,209
5576,25,40,3,1,69
5577,114,60,2,0,176
5578,110,30,2,3,145
5579,79,84,4,1,168
5580,56,84,2,1,143
5581,77,150,4,2,233
5582,18,12,0,0,30
5583,39,126,1,1,167
5584,37,50,1,2,90
5585,2,17,0,0,19
5586,3,17,2,0,22
5587,14,41,2,0,57
5588,61,46,0,0,107
5589,25,70,2,0,97
5590,168,128,1,0,297
5591,70,96,4,0,170
5592,64,92,2,0,158
5593,124,84,3,0,211
5594,97,94,1,1,193
5595,127,206,6,3,342
5596,104,231,6,3,344
5597,59,102,0,0,161
5598,239,152,1,0,392
5599,222,165,2,0,389
5600,218,164,1,1,384
5601,208,166,1,0,375
5602,198,170,7,0,375
5603,219,162,1,1,383
5604,222,178,0,0,400
5605,213,172,1,2,388
5606,200,121,4,0,325
5607,61,51,1,0,113
5608,31,14,0,0,45
5609,55,51,0,0,106
5610,12,9,0,0,21
5611,128,184,4,1,317
5612,155,168,4,1,328
5613,154,172,4,1,331
5614,44,56,1,1,102
5615,109,69,6,2,186
5616,121,112,1,0,234
5617,36,89,0,0,125
5618,24,6,0,0,30
5619,240,191,2,1,434
5620,245,182,8,0,435
5621,124,119,1,1,245
5622,126,122,4,0,252
5623,155,162,3,0,320
5624,111,148,3,0,262
5625,134,166,4,0,304
5626,114,153,5,2,274
5627,147,170,5,0,322
5628,139,146,0,0,285
5629,127,141,3,0,271
5630,58,115,2,0,175
5631,51,137,1,0,189
5632,48,258,5,0,311
5633,51,125,1,0,177
5634,101,126,4,0,231
5635,98,112,2,0,212
5636,109,158,6,0,273
5637,21,37,0,0,58
5638,135,192,4,1,332
5639,135,195,3,1,334
5640,119,165,0,0,284
5641,103,169,3,0,275
5642,136,162,4,0,302
5643,102,124,2,0,228
5644,97,177,7,1,282
5645,85,153,3,0,241
5646,123,142,0,2,267
5647,48,176,2,1,227
5648,53,110,0,0,163
5649,46,138,1,0,185
5650,96,205,2,0,303
5651,91,196,3,1,291
5652,37,118,0,2,157
5653,42,66,2,0,110
5654,13,41,0,0,54
5655,7,15,0,0,22
5656,52,147,3,0,202
5657,54,159,1,0,214
5658,9,30,1,0,40
5659,2,42,0,0,44
5660,32,77,0,0,109
5661,18,51,2,1,72
5662,12,26,1,0,39
5663,16,51,0,0,67
5664,16,60,1,0,77
5665,60,105,1,0,166
5666,50,152,2,2,206
5667,89,166,2,1,258
5668,110,145,0,1,256
5669,116,156,2,0,274
5670,105,144,1,0,250
5671,94,223,4,2,323
5672,81,202,4,0,287
5673,59,137,2,0,198
5674,67,99,2,1,169
5675,91,196,5,0,292
5676,84,171,3,1,259
5677,18,36,1,1,56
5678,87,190,3,0,280
5679,16,21,0,2,39
5680,18,52,1,1,72
5681,36,67,2,0,105
5682,14,37,2,0,53
5683,192,167,0,0,359
5684,225,147,0,0,372
5685,146,144,1,1,292
5686,153,125,4,1,283
5687,155,139,1,0,295
5688,140,132,6,1,279
5689,161,132,1,0,294
5690,202,143,2,0,347
5691,37,152,2,0,191
5692,122,170,4,0,296
5693,57,209,2,2,270
5694,83,189,1,0,273
5695,82,196,0,0,278
5696,22,56,2,1,81
5697,146,161,4,0,311
5698,138,135,6,1,280
5699,142,188,5,0,335
5700,123,189,0,0,312
5701,93,156,1,0,250
5702,135,158,0,0,293
5703,113,184,0,0,297
5704,97,177,0,0,274
5705,97,177,3,0,277
5706,129,126,2,0,257
5707,122,96,4,1,223
5708,121,122,4,0,247
5709,161,179,2,0,342
5710,207,119,1,1,328
5711,63,199,0,1,263
5712,8,5,2,0,15
5713,33,46,0,0,79
5714,148,190,3,0,341
5715,111,189,5,4,309
5716,14,33,0,0,47
5717,18,19,2,0,39
5718,16,10,0,0,26
5719,68,179,1,0,248
5720,35,52,0,2,89
5721,114,84,1,0,199
5722,184,162,1,0,347
5723,135,175,1,0,311
5724,147,173,1,1,322
5725,57,148,3,1,209
5726,62,150,1,1,214
5727,24,77,1,1,103
5728,130,148,2,0,280
5729,192,125,4,1,322
5730,138,136,0,0,274
5731,177,113,5,0,295
5732,168,117,4,0,289
5733,158,129,3,0,290
5734,158,97,4,0,259
5735,12,11,0,0,23
5736,106,171,5,1,283
5737,107,173,4,1,285
5738,104,127,2,0,233
5739,118,155,9,0,282
5740,116,66,1,1,184
5741,16,16,0,0,32
5742,134,174,2,2,312
5743,134,141,5,2,282
5744,113,117,3,1,234
5745,11,4,0,0,15
5746,152,122,4,0,278
5747,135,144,2,1,282
5748,125,148,3,1,277
5749,167,111,4,1,283
5750,131,149,3,0,283
5751,98,197,8,0,303
5752,98,185,5,3,291
5753,122,160,4,0,286
5754,75,181,4,2,262
5755,69,226,0,0,295
5756,72,134,0,0,206
5757,77,116,1,0,194
5758,13,16,1,0,30
5759,88,192,4,1,285
5760,92,205,4,1,302
5761,107,196,5,0,308
5762,116,198,8,4,326
5763,113,180,2,1,296
5764,98,198,6,0,302
5765,105,188,7,2,302
5766,107,215,6,0,328
5767,101,166,3,1,271
5768,118,184,5,1,308
5769,107,189,0,2,298
5770,109,189,6,1,305
5771,120,177,2,0,299
5772,11,21,0,0,32
5773,0,27,0,0,27
5774,12,21,0,0,33
5775,27,45,1,0,73
5776,74,143,3,0,220
5777,67,153,10,0,230
5778,21,68,2,0,91
5779,99,213,2,0,314
5780,108,195,2,0,305
5781,46,201,1,0,248
5782,60,140,4,1,205
5783,63,131,0,0,194
5784,57,54,2,1,114
5785,23,19,0,0,42
5786,83,80,3,0,166
5787,62,94,1,0,157
5788,101,126,0,2,229
5789,6,29,0,0,35
5790,14,116,1,0,131
5791,24,110,1,0,135
5792,44,95,3,1,143
5793,83,107,3,0,193
5794,41,202,2,0,245
5795,74,76,4,0,154
5796,202,150,2,0,354
5797,167,126,1,1,295
5798,208,131,4,2,345
5799,219,125,5,3,352
5800,202,159,3,0,364
5801,201,130,3,0,334
5802,153,150,1,1,305
5803,125,124,0,0,249
5804,148,113,5,2,268
5805,148,69,3,0,220
5806,214,158,4,0,376
5807,176,114,1,0,291
5808,153,109,0,0,262
5809,158,141,2,2,303
5810,72,53,0,0,125
5811,121,133,5,2,261
5812,161,119,4,0,284
5813,154,158,2,0,314
5814,3,11,0,0,14
5815,115,182,1,1,299
5816,166,126,3,1,296
5817,154,139,2,0,295
5818,159,138,4,0,301
5819,140,149,4,0,293
5820,129,162,2,0,293
5821,135,112,0,0,247
5822,115,120,5,1,241
5823,115,129,7,1,252
5824,98,139,4,0,241
5825,90,119,0,0,209
5826,108,103,10,2,223
5827,63,47,3,1,114
5828,113,113,5,3,234
5829,131,139,0,0,270
5830,42,36,1,1,80
5831,122,266,5,0,393
5832,209,155,5,5,374
5833,185,172,2,1,360
5834,238,123,8,1,370
5835,196,156,5,0,357
5836,106,54,2,0,162
5837,90,61,4,1,156
5838,122,59,4,0,185
5839,111,90,4,1,206
5840,145,83,4,3,235
5841,55,51,2,0,108
5842,60,61,2,0,123
5843,169,128,4,0,301
5844,58,51,1,0,110
5845,126,90,3,0,219
5846,140,81,0,0,221
5847,154,166,2,0,322
5848,34,17,1,0,52
5849,31,42,2,0,75
5850,117,72,2,1,192
5851,86,159,2,0,247
5852,80,188,7,1,276
5853,11,37,1,2,51
5854,78,138,0,0,216
5855,139,139,1,1,280
5856,68,63,5,0,136
5857,46,57,1,1,105
5858,64,130,9,3,206
5859,110,96,1,0,207
5860,106,88,4,2,200
5861,137,202,4,0,343
5862,44,137,5,2,188
5863,95,115,3,1,214
5864,110,120,4,1,235
5865,119,127,4,3,253
5866,109,142,6,3,260
5867,156,160,3,0,319
5868,120,162,2,0,284
5869,131,143,2,0,276
5870,139,92,2,0,233
5871,51,33,1,1,86
5872,28,72,3,0,103
5873,114,202,1,0,317
5874,108,198,4,1,311
5875,107,226,6,0,339
5876,136,161,3,0,300
5877,101,126,2,0,229
5878,91,136,2,2,231
5879,98,182,4,1,285
5880,96,172,2,3,273
5881,53,8,0,0,61
5882,53,46,1,0,100
5883,37,56,2,2,97
5884,41,124,1,0,166
5885,72,53,2,0,127
5886,42,41,1,0,84
5887,99,101,3,1,204
5888,108,137,2,0,247
5889,110,167,3,0,280
5890,4,5,0,0,9
5891,34,11,0,0,45
5892,20,23,2,0,45
5893,53,64,3,0,120
5894,64,73,0,0,137
5895,181,196,3,0,380
5896,234,169,0,1,404
5897,191,184,4,1,380
5898,95,82,1,0,178
5899,85,74,1,0,160
5900,71,39,3,1,114
5901,149,175,4,0,328
5902,135,175,1,0,311
5903,136,174,3,2,315
5904,136,190,2,0,328
5905,143,172,4,0,319
5906,151,170,2,1,324
5907,133,193,1,0,327
5908,134,186,5,1,326
5909,122,209,1,0,332
5910,158,164,0,0,322
5911,113,175,2,1,291
5912,140,182,6,2,330
5913,48,41,0,0,89
5914,55,97,4,0,156
5915,42,177,2,0,221
5916,109,149,2,0,260
5917,84,150,2,0,236
5918,88,141,0,1,230
5919,75,260,6,0,341
5920,119,147,1,0,267
5921,41,26,0,0,67
5922,79,242,6,0,327
5923,86,221,8,0,315
5924,111,193,4,0,308
5925,41,38,0,0,79
5926,104,134,4,1,243
5927,89,157,2,1,249
5928,9,132,1,0,142
5929,111,230,0,1,342
5930,104,206,0,1,311
5931,98,189,3,1,291
5932,13,8,1,0,22
5933,96,162,1,4,263
5934,110,158,5,2,275
5935,101,174,3,0,278
5936,104,156,0,2,262
5937,124,150,4,2,280
5938,113,160,0,2,275
5939,101,155,2,2,260
5940,95,180,4,1,280
5941,86,127,4,1,218
5942,121,138,3,0,262
5943,87,140,3,0,230
5944,55,129,5,2,191
5945,61,149,1,1,212
5946,54,177,2,2,235
5947,53,105,1,4,163
5948,73,172,3,0,248
5949,90,159,3,1,253
5950,116,167,2,0,285
5951,80,196,4,0,280
5952,77,161,1,1,240
5953,66,188,3,0,257
5954,54,153,2,0,209
5955,73,176,0,0,249
5956,52,153,1,0,206
5957,95,206,3,0,304
5958,91,237,3,0,331
5959,84,217,3,3,307
5960,89,239,3,2,333
5961,97,195,9,0,301
5962,103,210,5,3,321
5963,65,218,1,1,285
5964,64,101,5,0,170
5965,52,166,4,1,223
5966,44,152,2,1,199
5967,20,77,0,0,97
5968,92,177,1,0,270
5969,119,206,3,1,329
5970,73,188,2,2,265
5971,212,130,0,2,344
5972,210,124,1,1,336
5973,178,136,5,3,322
5974,191,108,2,2,303
5975,190,136,2,0,328
5976,221,136,1,0,358
5977,175,113,6,1,295
5978,137,128,2,0,267
5979,135,130,3,0,268
5980,169,132,3,0,304
5981,164,143,6,1,314
5982,120,132,1,0,253
5983,48,42,0,0,90
5984,49,27,2,3,81
5985,126,89,4,1,220
5986,131,135,4,0,270
5987,126,144,3,1,274
5988,183,162,7,1,353
5989,229,140,7,1,377
5990,221,113,2,0,336
5991,146,110,3,0,259
5992,171,77,1,0,249
5993,187,170,6,2,365
5994,161,149,6,1,317
5995,170,166,7,1,344
5996,139,143,4,0,286
5997,134,154,4,0,292
5998,132,160,10,0,302
5999,130,143,4,0,277
6000,148,152,4,2,306
6001,163,128,4,0,295
6002,160,141,4,3,308
6003,112,155,4,3,274
6004,120,174,3,1,298
6005,96,193,2,2,293
6006,100,190,4,0,294
6007,105,169,2,1,277
6008,118,184,6,1,309
6009,90,219,3,0,312
6010,88,177,1,0,266
6011,119,123,9,1,252
6012,160,191,4,0,355
6013,127,201,6,1,335
6014,139,185,4,0,328
6015,123,178,5,2,308
6016,148,160,2,0,310
6017,132,183,3,0,318
6018,126,173,6,1,306
6019,109,144,5,0,258
6020,185,191,4,0,380
6021,188,138,5,2,333
6022,159,147,6,0,312
6023,155,188,6,0,349
6024,181,168,3,1,353
6025,132,152,2,0,286
6026,135,132,6,1,274
6027,125,175,4,1,305
6028,145,151,4,0,300
6029,154,153,5,2,314
6030,92,199,4,1,296
6031,87,211,3,1,302
6032,68,238,3,1,310
6033,58,202,6,0,266
6034,71,216,0,0,287
6035,87,195,2,0,284
6036,73,206,1,0,280
6037,84,224,9,0,317
6038,82,168,6,0,256
6039,46,81,1,0,128
6040,169,121,5,0,295
6041,144,110,3,2,259
6042,156,107,3,2,268
6043,127,157,8,0,292
6044,154,126,6,1,287
6045,89,180,7,2,278
6046,86,184,1,0,271
6047,75,177,1,0,253
6048,76,185,5,0,266
6049,79,166,5,0,250
6050,115,190,4,1,310
6051,118,197,2,1,318
6052,101,187,1,0,289
6053,111,208,4,0,323
6054,109,200,5,1,315
6055,100,207,3,0,310
6056,92,240,5,2,339
6057,107,218,1,2,328
6058,95,197,3,0,295
6059,89,167,6,0,262
6060,95,210,4,0,309
6061,153,177,6,1,337
6062,131,197,10,1,339
6063,112,195,6,0,313
6064,143,162,4,0,309
6065,116,150,4,0,270
6066,33,113,1,0,147
6067,8,6,1,0,15
6068,98,181,7,1,287
6069,105,191,4,2,302
6070,110,204,10,0,324
6071,103,185,5,3,296
6072,101,188,3,2,294
6073,105,192,5,0,302
6074,95,190,7,2,294
6075,90,181,5,1,277
6076,94,176,2,0,272
6077,159,157,7,2,325
6078,90,126,4,0,220
6079,90,125,1,1,217
6080,68,160,6,0,234
6081,79,143,4,1,227
6082,40,164,6,1,211
6083,52,240,2,0,294
6084,28,221,4,0,253
6085,40,217,2,1,260
6086,52,91,3,1,147
6087,50,157,3,0,210
6088,53,195,3,2,253
6089,49,118,2,0,169
6090,47,143,2,1,193
6091,44,178,2,2,226
6092,55,231,9,3,298
6093,83,167,3,0,253
6094,75,166,4,1,246
6095,66,132,3,1,202
6096,20,169,13,1,203
6097,13,148,7,1,169
6098,1,65,3,0,69
6099,41,238,5,1,285
6100,76,118,12,0,206
6101,5,178,2,0,185
6102,6,184,2,0,192
6103,12,7,1,0,20
6104,74,207,1,1,283
6105,54,196,2,1,253
6106,53,179,2,0,234
6107,62,164,5,0,231
6108,60,188,5,0,253
6109,72,177,3,0,252
6110,71,169,4,2,246
6111,77,142,0,0,219
6112,25,74,1,0,100
6113,56,114,2,0,172
6114,60,122,1,1,184
6115,38,93,4,0,135
6116,30,72,3,0,105
6117,28,75,6,3,112
6118,4,11,1,0,16
6119,94,154,6,1,255
6120,100,190,3,0,293
6121,53,75,4,0,132
6122,54,196,2,1,253
6123,48,189,2,4,243
6124,63,155,6,0,224
6125,55,185,3,0,243
6126,73,136,2,0,211
6127,37,168,2,1,208
6128,31,115,3,0,149
6129,68,226,7,1,302
6130,58,223,3,2,286
6131,243,187,2,0,432
6132,222,199,3,0,424
6133,221,173,4,1,399
6134,228,172,3,1,404
6135,213,179,6,0,398
6136,241,166,1,0,408
6137,219,165,3,1,388
6138,228,166,2,1,397
6139,250,164,5,0,419
6140,218,173,4,2,397
6141,229,186,3,1,419
6142,220,171,7,2,400
6143,213,182,1,0,396
6144,235,164,4,1,404
6145,236,172,3,1,412
6146,222,194,4,1,421
6147,242,155,5,1,403
6148,221,183,2,2,408
6149,200,163,2,0,365
6150,177,156,2,0,335
6151,211,168,5,1,385
6152,187,155,3,0,345
6153,216,143,6,0,365
6154,155,176,2,1,334
6155,161,185,2,0,348
6156,216,179,4,0,399
6157,231,185,3,0,419
6158,200,170,5,1,376
6159,219,158,4,0,381
6160,199,170,2,0,371
6161,202,165,2,0,369
6162,65,162,1,0,228
6163,85,153,2,0,240
6164,62,132,0,0,194
6165,62,129,1,0,192
6166,14,14,1,1,30
6167,148,230,2,0,380
6168,142,233,4,2,381
6169,141,225,4,0,370
6170,157,215,2,0,374
6171,147,185,3,0,335
6172,134,199,2,0,335
6173,208,205,3,0,416
6174,178,200,6,1,385
6175,186,165,5,0,356
6176,205,173,2,0,380
6177,182,174,1,0,357
6178,209,178,0,0,387
6179,139,196,4,0,339
6180,215,136,5,0,356
6181,211,126,3,1,341
6182,146,154,4,0,304
6183,148,116,3,0,267
6184,161,149,3,0,313
6185,170,162,0,0,332
6186,87,263,4,0,354
6187,87,255,4,1,347
6188,100,199,2,0,301
6189,92,133,2,0,227
6190,103,166,4,0,273
6191,143,242,5,1,391
6192,155,230,3,2,390
6193,147,206,2,0,355
6194,137,254,11,2,404
6195,173,218,2,0,393
6196,139,243,4,2,388
6197,163,214,3,0,380
6198,149,214,3,1,367
6199,156,181,2,0,339
6200,69,208,0,0,277
6201,65,187,6,0,258
6202,73,225,4,0,302
6203,94,247,3,2,346
6204,110,230,6,0,346
6205,94,156,1,0,251
6206,95,206,0,0,301
6207,86,153,1,0,240
6208,70,192,4,0,266
6209,87,174,2,0,263
6210,72,177,2,0,251
6211,57,202,2,0,261
6212,71,177,1,1,250
6213,156,106,2,0,264
6214,72,201,2,1,276
6215,60,126,2,1,189
6216,63,192,3,1,259
6217,83,163,2,0,248
6218,83,185,2,0,270
6219,36,53,1,0,90
6220,42,78,0,0,120
6221,74,149,1,1,225
6222,58,158,0,0,216
6223,21,93,1,0,115
6224,135,230,3,0,368
6225,124,225,3,0,352
6226,129,206,1,3,339
6227,133,237,4,0,374
6228,100,202,3,2,307
6229,127,187,5,0,319
6230,129,211,1,0,341
6231,40,141,0,0,181
6232,37,153,2,0,192
6233,93,153,2,1,249
6234,124,198,2,0,324
6235,114,206,3,1,324
6236,102,187,3,0,292
6237,114,195,2,0,311
6238,105,175,3,0,283
6239,39,50,1,0,90
6240,24,46,1,0,71
6241,6,75,0,0,81
6242,54,237,4,0,295
6243,74,210,5,0,289
6244,61,213,4,1,279
6245,60,72,1,0,133
6246,6,17,0,0,23
6247,148,211,3,0,362
6248,139,197,4,1,341
6249,155,171,6,1,333
6250,156,199,2,1,358
6251,119,223,2,0,344
6252,120,235,2,1,358
6253,105,211,4,1,321
6254,120,201,3,0,324
6255,126,217,1,1,345
6256,112,212,2,0,326
6257,135,215,4,0,354
6258,123,196,2,0,321
6259,110,215,2,2,329
6260,113,186,1,1,301
6261,118,195,3,0,316
6262,74,187,1,0,262
6263,64,189,2,0,255
6264,81,178,1,2,262
6265,118,255,2,2,377
6266,136,217,2,0,355
6267,96,225,3,0,324
6268,86,215,1,0,302
6269,86,226,1,1,314
6270,100,196,2,0,298
6271,99,225,1,0,325
6272,77,232,3,0,312
6273,88,209,6,1,304
6274,111,157,0,1,269
6275,76,164,3,1,244
6276,99,186,4,0,289
6277,100,189,5,1,295
6278,104,203,0,0,307
6279,84,102,1,2,189
6280,104,245,5,1,355
6281,88,227,3,0,318
6282,94,228,1,0,323
6283,122,206,1,0,329
6284,113,206,2,0,321
6285,98,197,1,0,296
6286,109,196,1,0,306
6287,98,193,4,1,296
6288,78,211,1,1,291
6289,68,194,2,3,267
6290,93,159,3,0,255
6291,86,164,2,0,252
6292,102,199,1,0,302
6293,10,21,1,0,32
6294,69,73,3,0,145
6295,104,156,5,1,266
6296,74,155,0,0,229
6297,9,31,0,0,40
6298,179,207,2,1,389
6299,158,217,1,0,376
6300,174,207,2,0,383
6301,163,200,0,2,365
6302,165,188,3,0,356
6303,158,207,3,0,368
6304,172,185,5,0,362
6305,119,187,4,0,310
6306,100,202,1,1,304
6307,129,200,3,2,334
6308,117,179,4,0,300
6309,85,146,0,1,232
6310,90,161,3,0,254
6311,167,207,5,1,380
6312,139,198,7,2,346
6313,132,169,4,1,306
6314,177,184,2,0,363
6315,128,206,7,0,341
6316,136,158,6,1,301
6317,111,194,5,0,310
6318,119,190,2,0,311
6319,131,182,2,2,317
6320,139,177,3,0,319
6321,143,186,3,2,334
6322,149,166,6,0,321
6323,124,192,1,0,317
6324,130,171,6,1,308
6325,73,264,2,2,341
6326,84,189,3,2,278
6327,49,167,1,0,217
6328,161,74,7,3,245
6329,154,89,5,0,248
6330,84,143,1,0,228
6331,102,123,4,0,229
6332,63,165,1,0,229
6333,64,162,3,1,230
6334,31,189,2,0,222
6335,36,192,1,0,229
6336,88,29,1,0,118
6337,92,164,5,0,261
6338,79,167,3,1,250
6339,73,54,2,0,129
6340,29,89,0,0,118
6341,13,65,0,0,78
6342,50,156,5,1,212
6343,47,166,0,1,214
6344,106,213,4,0,323
6345,103,219,5,2,329
6346,108,237,6,2,353
6347,98,248,4,0,350
6348,119,220,3,0,342
6349,116,242,4,0,362
6350,106,214,2,0,322
6351,92,235,5,0,332
6352,91,206,3,0,300
6353,121,199,4,1,325
6354,97,184,4,3,288
6355,94,208,6,0,308
6356,114,198,3,1,316
6357,52,118,2,1,173
6358,44,131,4,2,181
6359,110,188,3,0,301
6360,97,207,5,0,309
6361,88,181,3,1,273
6362,45,160,4,0,209
6363,57,149,1,0,207
6364,25,90,3,0,118
6365,85,237,4,0,326
6366,21,145,0,1,167
6367,50,167,4,1,222
6368,23,26,1,0,50
6369,91,238,1,2,332
6370,107,228,3,0,338
6371,101,56,0,0,157
6372,35,21,0,0,56
6373,29,27,0,0,56
6374,90,181,0,1,272
6375,77,128,3,0,208
6376,85,151,3,1,240
6377,138,148,2,0,288
6378,116,142,5,0,263
6379,98,193,4,0,295
6380,107,192,1,1,301
6381,109,179,4,0,292
6382,101,223,3,1,328
6383,99,179,8,2,288
6384,104,209,2,0,315
6385,107,180,3,0,290
6386,15,101,0,0,116
6387,82,211,4,0,297
6388,16,28,0,0,44
6389,179,168,6,1,354
6390,182,167,4,0,353
6391,136,200,1,1,338
6392,92,207,2,3,304
6393,125,169,3,1,298
6394,93,197,4,2,296
6395,80,173,1,0,254
6396,95,193,3,1,292
6397,68,165,3,1,237
6398,91,219,2,0,312
6399,75,215,3,0,293
6400,75,225,5,0,305
6401,95,207,8,0,310
6402,90,205,4,2,301
6403,48,214,2,1,265
6404,47,207,3,0,257
6405,61,190,8,2,261
6406,42,219,6,3,270
6407,57,173,1,1,232
6408,5,3,1,0,9
6409,50,124,2,1,177
6410,60,125,1,0,186
6411,71,106,4,0,181
6412,63,159,1,1,224
6413,63,175,7,0,245
6414,78,145,0,0,223
6415,21,100,3,0,124
6416,86,180,2,0,268
6417,66,183,3,0,252
6418,86,185,1,2,274
6419,135,123,4,0,262
6420,135,110,5,0,250
6421,111,112,4,0,227
6422,121,128,4,3,256
6423,121,130,2,1,254
6424,72,95,2,1,170
6425,73,202,2,1,278
6426,54,192,1,1,248
6427,67,216,2,0,285
6428,76,199,2,1,278
6429,34,38,1,1,74
6430,118,167,10,0,295
6431,45,165,9,1,220
6432,53,150,6,0,209
6433,47,136,7,0,190
6434,59,152,8,0,219
6435,25,183,1,0,209
6436,24,79,2,0,105
6437,23,90,2,2,117
6438,49,201,4,0,254
6439,58,190,5,0,253
6440,20,57,6,0,83
6441,23,78,2,0,103
6442,2,77,4,0,83
6443,62,210,1,0,273
6444,75,213,2,0,290
6445,69,189,6,0,264
6446,59,225,2,1,287
6447,36,173,4,0,213
6448,92,162,0,0,254
6449,38,143,9,0,190
6450,58,172,1,0,231
6451,62,207,0,0,269
6452,20,111,1,0,132
6453,20,128,3,4,155
6454,40,113,2,0,155
6455,94,216,5,0,315
6456,130,214,5,0,349
6457,101,220,3,0,324
6458,105,228,3,0,336
6459,87,235,5,0,327
6460,107,209,5,0,321
6461,69,232,4,2,307
6462,88,242,1,1,332
6463,104,204,4,0,312
6464,107,226,5,0,338
6465,104,219,6,1,330
6466,105,233,4,0,342
6467,59,109,8,1,177
6468,65,122,3,0,190
6469,65,207,3,2,277
6470,62,180,1,1,244
6471,105,252,4,1,362
6472,44,174,1,1,220
6473,54,162,1,0,217
6474,50,100,0,0,150
6475,59,126,1,4,190
6476,51,218,4,0,273
6477,34,231,4,0,269
6478,33,224,2,0,259
6479,41,250,10,1,302
6480,71,209,5,0,285
6481,50,223,3,1,277
6482,40,236,4,1,281
6483,63,217,4,0,284
6484,53,228,5,1,287
6485,53,227,0,0,280
6486,107,256,3,1,367
6487,121,192,2,1,316
6488,135,175,6,0,316
6489,124,205,2,0,331
6490,160,192,2,0,354
6491,167,173,2,0,342
6492,137,166,6,0,309
6493,137,207,4,0,348
6494,146,173,3,1,323
6495,166,184,5,1,356
6496,155,159,4,0,318
6497,121,213,1,0,335
6498,126,172,1,1,300
6499,134,176,1,0,311
6500,167,184,1,0,352
6501,128,197,0,0,325
6502,159,176,1,0,336
6503,127,102,2,0,231
6504,131,98,2,2,233
6505,80,139,6,0,225
6506,79,154,0,2,235
6507,156,215,2,0,373
6508,141,151,0,3,295
6509,105,165,4,2,276
6510,24,78,0,0,102
6511,4,6,0,2,12
6512,129,178,0,0,307
6513,123,145,0,0,268
6514,107,225,3,1,336
6515,101,182,9,2,294
6516,104,205,1,0,310
6517,110,180,5,0,295
6518,84,189,10,0,283
6519,15,11,0,1,27
6520,74,250,6,0,330
6521,59,239,1,4,303
6522,77,255,7,0,339
6523,145,214,3,0,362
6524,106,215,3,2,326
6525,113,232,2,0,347
6526,121,233,2,2,358
6527,113,238,7,0,358
6528,109,244,3,0,356
6529,110,233,2,0,345
6530,108,236,3,1,348
6531,85,235,6,2,328
6532,56,218,5,1,280
6533,90,222,5,0,317
6534,68,300,0,0,368
6535,109,228,3,1,341
6536,91,223,2,1,317
6537,89,233,4,0,326
6538,72,102,3,0,177
6539,52,117,0,1,170
6540,93,221,1,0,315
6541,92,217,1,1,311
6542,93,222,1,0,316
6543,158,6,0,0,164
6544,62,7,0,1,70
6545,38,2,0,0,40
6546,41,6,0,0,47
6547,2,1,0,0,3
6548,13,0,0,0,13
6549,70,11,0,0,81
6550,90,20,0,0,110
6551,81,19,3,0,103
6552,24,4,1,0,29
6553,23,1,0,0,24
6554,53,9,1,0,63
6555,9,5,0,0,14
6556,15,4,0,0,19
6557,18,2,0,0,20
6558,56,18,0,0,74
6559,46,20,0,0,66
6560,51,24,0,0,75
6561,60,41,1,0,102
6562,65,30,0,0,95
6563,45,20,0,0,65
6564,58,13,0,0,71
6565,47,16,0,1,64
6566,33,27,0,0,60
6567,43,18,0,0,61
6568,65,22,0,0,87
6569,57,22,1,0,80
6570,70,17,0,0,87
6571,50,40,1,0,91
6572,70,34,0,0,104
6573,68,31,1,0,100
6574,57,12,0,0,69
6575,66,28,1,0,95
6576,56,30,0,0,86
6577,60,23,1,0,84
6578,78,27,0,0,105
6579,49,21,0,0,70
6580,110,25,2,0,137
6581,112,21,1,2,136
6582,104,22,0,1,127
6583,55,17,1,0,73
6584,147,36,2,1,186
6585,152,9,1,1,163
6586,116,46,0,0,162
6587,38,32,0,0,70
6588,10,5,0,0,15
6589,45,8,2,0,55
6590,21,3,0,0,24
6591,167,35,4,0,206
6592,12,11,0,0,23
6593,46,17,0,0,63
6594,102,9,1,0,112
6595,142,48,2,1,193
6596,17,10,1,0,28
6597,43,12,1,0,56
6598,112,11,0,0,123
6599,28,12,0,0,40
6600,11,1,0,1,13
6601,5,5,0,0,10
6602,74,8,1,0,83
6603,2,1,0,0,3
6604,6,4,1,0,11
6605,21,10,0,1,32
6606,3,0,0,0,3
6607,17,5,1,0,23
6608,5,1,0,0,6
6609,5,6,1,0,12
6610,31,8,0,0,39
6611,0,0,0,0,0
6612,1,0,0,0,1
