1,1,108,0,0,6,36,70,3,5,3,10,34,86,362,2,1,365,235,600
2,0,94,1,0,3,35,63,1,3,0,10,42,88,340,5,0,345,230,575
3,0,98,4,2,6,32,102,3,1,1,8,52,84,393,3,0,396,204,600
4,2,96,0,2,7,43,88,4,4,0,18,39,100,403,0,0,403,197,600
5,0,84,1,1,6,29,86,2,2,0,9,37,134,391,1,1,393,207,600
6,1,96,2,0,10,30,62,0,1,0,9,33,91,335,1,0,336,164,500
7,0,65,1,0,4,33,65,3,2,1,13,43,76,306,4,0,310,190,500
8,2,96,1,0,7,36,73,4,8,1,9,34,71,342,1,1,344,156,500
9,1,85,1,0,4,24,74,1,2,1,12,35,83,323,1,0,324,168,492
10,1,80,2,0,3,46,55,5,2,1,16,74,56,341,2,0,343,257,600
11,2,84,1,1,2,40,82,5,3,2,21,73,53,369,2,2,373,227,600
12,1,94,2,0,5,48,70,3,3,2,8,77,52,365,3,3,371,229,600
13,0,82,0,0,3,47,84,5,5,2,22,81,58,389,3,0,392,208,600
14,0,63,0,0,1,45,70,4,0,2,16,83,53,337,2,1,340,260,600
15,4,80,3,1,2,58,71,12,1,1,16,82,44,375,0,0,375,225,600
16,0,86,1,0,1,40,72,6,5,1,24,79,53,368,3,0,371,229,600
17,1,72,1,3,2,48,81,6,5,0,15,80,49,363,5,0,368,232,600
18,2,71,0,0,2,55,70,4,3,4,19,85,55,370,1,0,371,229,600
19,4,76,2,2,3,36,61,4,3,2,20,74,54,341,3,1,345,255,600
20,1,99,2,4,4,48,50,8,2,1,23,78,60,380,1,0,381,219,600
21,2,87,1,1,2,39,69,5,3,3,20,89,40,361,5,10,376,233,609
22,2,88,1,0,1,48,78,1,0,5,9,72,50,355,2,0,357,223,580
23,0,71,1,1,4,38,70,8,2,1,16,64,52,328,7,0,335,215,550
24,1,95,2,0,7,38,59,1,2,0,16,80,71,372,4,2,378,172,550
25,0,89,0,1,4,32,77,2,1,4,7,43,70,330,3,0,333,191,524
26,0,107,0,0,3,29,63,2,4,1,6,49,59,323,6,1,330,170,500
27,2,64,4,0,2,45,60,7,2,3,13,82,38,322,3,0,325,275,600
28,1,52,1,0,3,44,65,3,5,1,11,73,41,300,0,0,300,250,550
29,0,54,1,1,2,43,57,0,2,1,10,43,39,253,2,1,256,257,513
30,2,87,2,0,5,41,80,3,3,3,24,101,42,393,1,0,394,206,600
41,2,75,4,0,5,65,54,0,5,3,17,113,49,392,0,1,393,207,600
42,1,60,0,1,0,46,59,5,2,1,21,107,52,355,4,2,361,239,600
43,2,65,1,2,5,36,79,3,3,3,25,116,46,386,2,1,389,211,600
44,1,64,1,0,3,45,67,3,2,0,22,109,66,383,2,0,385,215,600
45,0,77,0,0,3,57,70,2,6,2,14,102,43,376,4,2,382,218,600
46,0,66,1,1,3,59,61,4,3,4,28,98,42,370,2,0,372,227,599
47,3,70,1,0,4,53,56,5,4,4,16,119,33,368,4,0,372,228,600
48,2,65,3,0,2,56,56,4,6,1,24,104,43,366,2,1,369,231,600
49,1,92,2,0,0,40,77,3,3,1,29,108,41,397,2,1,400,200,600
50,1,77,1,0,4,46,82,3,1,3,17,115,34,384,5,0,389,211,600
51,3,89,2,0,4,45,59,3,7,1,32,97,38,380,1,3,384,216,600
52,0,72,4,1,1,44,64,6,2,2,15,136,35,382,4,1,387,223,610
53,2,71,4,3,2,35,54,3,3,2,27,85,43,334,0,0,334,279,613
54,2,96,4,2,1,40,85,8,2,1,14,82,93,430,3,2,435,165,600
55,3,78,1,1,1,38,105,1,7,1,16,70,99,421,3,0,424,176,600
56,3,84,0,0,3,25,72,5,3,0,10,71,96,372,0,0,372,174,546
57,0,63,3,0,3,36,71,2,3,0,17,74,69,341,3,2,346,154,500
58,3,87,0,1,1,32,73,2,2,2,11,49,84,347,2,0,349,151,500
59,0,2,0,0,1,0,5,1,1,0,2,11,2,25,0,0,25,375,400
60,0,4,0,0,2,1,6,2,0,9,0,0,3,27,0,0,27,372,399
61,0,78,0,0,2,39,61,2,1,2,18,44,69,316,1,2,319,253,572
62,0,59,1,3,2,37,53,2,0,1,10,29,65,262,0,1,263,237,500
64,0,105,1,0,1,38,86,4,2,5,13,76,50,381,0,0,381,219,600
65,0,82,2,0,5,52,84,2,1,4,8,67,82,389,2,2,393,207,600
67,0,108,2,2,4,42,67,6,2,1,19,70,65,388,2,0,390,210,600
68,0,74,0,1,8,44,85,5,1,2,15,83,66,384,4,0,388,212,600
69,1,98,3,1,3,48,58,9,5,2,14,74,50,366,2,0,368,232,600
71,2,78,1,1,1,52,68,4,6,1,10,69,41,334,1,1,336,177,513
72,0,76,1,1,4,33,70,7,3,1,13,63,59,331,0,0,331,169,500
73,1,70,0,0,4,30,60,4,3,0,14,77,73,336,0,1,337,163,500
74,2,70,1,2,6,33,68,1,1,4,20,77,52,337,1,1,339,161,500
75,2,91,1,0,0,36,60,5,0,3,12,65,40,315,4,0,319,181,500
76,3,124,0,1,4,44,73,5,4,2,17,83,72,432,1,2,435,183,618
77,1,113,0,1,3,46,80,5,3,4,24,97,68,445,5,0,450,168,618
78,2,123,0,3,3,41,76,2,4,2,12,90,76,434,2,0,436,182,618
79,0,99,1,1,4,47,93,5,1,5,19,68,86,429,3,1,433,167,600
81,1,117,2,2,1,41,79,5,3,3,24,62,91,431,4,0,435,165,600
82,1,91,0,0,7,32,85,3,0,2,22,70,90,403,2,0,405,195,600
83,0,117,4,0,2,51,82,2,3,2,18,50,81,412,1,0,413,169,582
84,2,104,3,1,3,40,78,2,4,2,21,50,61,371,2,0,373,177,550
85,1,99,0,0,8,41,52,5,5,2,19,60,71,363,5,0,368,182,550
86,1,98,2,1,3,42,81,3,6,1,16,51,89,394,1,1,396,154,550
87,2,89,4,0,4,33,57,6,4,1,24,64,69,357,1,1,359,191,550
88,0,124,1,0,3,25,98,2,5,1,17,98,82,456,6,0,462,138,600
89,1,116,2,0,4,58,92,3,7,0,11,77,69,440,1,0,441,159,600
90,2,107,3,3,5,40,72,2,5,0,16,88,82,425,1,1,427,173,600
91,1,110,3,2,0,29,84,6,6,4,13,103,69,430,0,0,430,170,600
92,1,108,0,1,3,56,55,8,3,1,19,79,95,429,0,0,429,171,600
93,1,110,1,1,6,41,79,5,3,2,19,83,79,430,4,0,434,162,596
94,0,109,2,0,2,40,99,0,2,1,21,69,76,421,2,0,423,177,600
95,0,117,3,1,2,41,89,4,5,0,13,75,63,413,1,0,414,186,600
96,0,114,3,0,4,30,85,4,2,3,12,69,93,419,4,1,424,176,600
97,1,117,2,1,4,37,81,6,6,5,17,94,62,433,2,0,435,165,600
98,1,119,0,0,4,43,70,8,3,1,16,79,69,413,8,0,421,179,600
99,0,103,3,0,4,42,81,5,4,7,21,94,80,444,4,0,448,152,600
100,0,99,0,0,5,61,70,3,5,2,13,86,78,422,2,0,424,176,600
101,0,96,2,1,5,50,90,3,5,3,24,83,72,434,1,0,435,165,600
102,1,96,4,2,5,46,72,1,4,5,15,95,72,418,2,3,423,177,600
103,1,111,1,1,5,44,71,2,5,4,12,84,76,417,3,1,421,179,600
104,2,112,0,0,4,29,71,3,1,0,21,104,78,425,1,1,427,173,600
105,0,117,1,2,5,40,55,6,3,0,22,74,55,380,6,0,386,139,525
106,2,88,3,0,5,28,71,6,4,0,20,91,65,383,2,0,385,140,525
107,2,97,2,1,7,34,60,2,2,2,10,65,76,360,2,0,362,138,500
108,2,109,1,0,2,35,65,2,0,2,10,55,66,349,1,1,351,149,500
109,0,110,2,0,2,36,54,9,4,3,13,57,70,360,0,0,360,140,500
110,0,82,0,0,3,38,73,3,5,2,15,61,63,345,0,0,345,155,500
111,0,148,2,1,1,47,66,5,1,1,10,71,104,457,1,1,459,141,600
112,2,149,0,3,1,48,68,2,6,2,9,45,115,450,0,0,450,150,600
113,1,152,1,1,5,42,79,3,1,2,7,64,113,471,3,0,474,126,600
114,0,135,0,1,2,44,89,9,6,1,9,57,80,433,0,0,433,167,600
115,0,138,2,0,2,29,83,4,5,2,11,36,95,407,1,0,408,142,550
116,0,116,2,1,3,35,81,4,1,3,12,54,86,398,2,2,402,148,550
117,0,109,0,3,2,34,73,1,4,1,9,48,85,369,1,0,370,130,500
118,0,104,0,1,3,39,67,3,7,1,4,38,103,370,2,0,372,128,500
119,1,106,2,2,4,38,79,5,7,0,14,28,62,348,1,0,349,152,501
120,0,127,1,0,3,38,93,2,4,5,12,68,93,446,1,0,447,153,600
121,2,120,0,0,0,45,85,1,3,2,18,63,118,457,3,0,460,140,600
122,1,122,3,0,7,44,82,3,6,0,6,88,84,446,0,0,446,154,600
123,0,125,1,0,4,39,93,0,3,1,13,74,93,446,3,0,449,151,600
124,0,121,4,0,2,36,75,4,3,2,13,79,97,436,5,1,442,158,600
125,0,122,4,1,5,29,71,5,3,0,13,56,92,401,0,1,402,198,600
126,0,136,0,0,3,37,89,1,4,1,16,85,88,460,3,0,463,137,600
127,3,118,2,1,12,31,85,1,6,3,16,56,98,432,0,0,432,168,600
128,1,115,1,2,6,40,90,6,5,1,18,65,85,435,1,3,439,161,600
129,1,113,1,0,1,44,95,3,2,1,13,76,97,447,1,0,448,152,600
130,1,116,1,0,7,54,82,1,4,0,16,60,94,436,2,0,438,162,600
131,0,138,4,0,4,41,113,4,5,0,8,69,75,461,3,0,464,136,600
141,1,122,5,1,2,44,81,7,5,3,4,73,105,453,1,1,455,145,600
142,1,124,3,0,4,37,83,7,8,0,8,76,87,438,3,0,441,159,600
143,1,132,1,1,1,36,110,2,4,1,9,57,85,440,1,0,441,159,600
144,0,130,1,2,10,47,84,7,2,3,9,53,80,428,1,0,429,171,600
145,3,128,2,0,3,40,85,5,3,1,13,55,93,431,2,0,433,167,600
146,0,124,3,0,4,41,75,3,6,1,10,68,90,425,2,0,427,173,600
147,0,119,2,0,4,44,86,3,7,3,12,83,72,435,2,0,437,163,600
148,2,114,1,1,7,34,83,1,4,0,11,74,70,402,0,0,402,130,532
149,0,110,0,0,5,31,63,5,0,1,10,65,80,370,3,0,373,127,500
150,0,108,2,0,3,36,64,6,1,1,11,70,75,377,1,0,378,122,500
152,1,102,0,0,1,29,74,5,1,0,12,63,87,375,3,1,379,221,600
153,1,84,0,0,2,28,63,6,3,2,12,60,118,379,3,1,383,217,600
154,2,93,3,1,2,20,63,8,2,1,14,70,99,378,2,1,381,219,600
155,0,96,0,1,4,28,65,4,4,0,7,43,82,334,0,2,336,214,550
156,1,85,1,0,3,28,81,3,1,4,4,55,56,322,3,0,325,212,537
157,2,92,0,0,1,27,74,3,5,0,6,37,177,424,3,0,427,173,600
158,0,116,0,0,3,38,92,2,3,1,7,40,130,432,0,0,432,168,600
160,1,112,2,1,5,32,80,3,3,2,2,47,151,441,2,0,443,157,600
162,2,44,0,1,1,22,101,7,0,1,12,73,46,310,2,0,312,164,476
164,1,40,1,0,2,24,28,2,3,1,30,172,11,315,7,0,322,179,501
165,0,26,0,1,4,22,51,7,0,2,16,201,9,339,5,2,346,154,500
167,2,39,0,0,1,25,41,3,2,7,0,138,30,288,5,3,296,304,600
168,4,34,0,1,0,18,25,4,3,0,5,126,20,240,3,1,244,356,600
169,0,39,2,1,0,16,41,4,2,0,8,143,23,279,5,0,284,316,600
171,1,40,1,2,0,19,26,2,0,1,7,123,27,249,2,0,251,343,594
172,1,33,1,1,1,15,39,1,1,2,6,134,34,269,2,1,272,277,549
174,0,110,3,2,9,37,62,5,5,1,16,104,83,437,2,0,439,161,600
175,2,117,4,1,5,35,81,4,7,0,12,81,82,431,6,1,438,162,600
176,2,104,3,1,5,45,78,3,2,1,13,103,85,445,4,0,449,151,600
177,1,92,1,2,8,41,85,3,3,1,10,96,62,405,7,0,412,138,550
178,0,98,2,1,4,28,61,3,5,1,10,85,60,358,4,0,362,138,500
179,3,114,2,0,1,31,62,7,7,3,18,76,56,380,2,0,382,132,514
180,0,2,0,1,0,7,23,3,1,1,0,12,6,56,1,1,58,72,130
182,1,89,0,0,1,22,101,2,4,0,4,43,150,417,2,0,419,181,600
183,1,88,3,0,0,27,113,4,5,0,4,34,138,417,1,0,418,182,600
185,0,62,2,0,4,37,93,1,4,1,2,20,109,335,3,0,338,172,510
188,1,105,2,2,5,43,92,0,3,3,9,74,104,443,5,0,448,152,600
189,2,97,0,1,4,38,87,6,4,2,11,43,134,429,1,0,430,170,600
191,0,100,2,1,2,41,75,1,6,1,14,59,117,419,5,1,425,175,600
192,1,101,2,1,3,37,84,4,6,3,8,63,104,417,3,1,421,179,600
193,1,114,2,0,2,33,81,2,1,0,10,47,87,380,1,1,382,186,568
194,0,107,2,0,1,35,92,1,5,4,16,67,109,439,3,0,442,158,600
195,1,100,1,0,3,46,108,1,2,2,8,62,112,446,2,0,448,152,600
196,0,92,0,0,2,35,85,6,3,1,19,59,119,421,3,0,424,176,600
201,2,94,0,0,1,33,104,1,1,4,6,68,85,399,1,0,400,200,600
203,1,93,2,0,2,24,117,4,1,1,10,51,114,420,0,0,420,180,600
204,0,97,2,0,2,42,106,4,4,1,10,45,126,439,4,0,443,157,600
205,1,103,1,0,2,30,97,8,2,1,9,47,130,431,3,0,434,166,600
206,2,104,2,0,5,28,88,4,2,1,13,67,117,433,4,0,437,163,600
207,1,97,3,0,1,31,123,4,5,0,6,46,104,421,5,0,426,174,600
208,0,125,2,0,3,30,76,5,4,1,8,57,103,414,1,0,415,185,600
209,1,86,1,1,0,38,100,3,2,0,12,90,106,440,0,1,441,159,600
210,1,85,2,0,1,45,89,3,2,1,12,61,109,411,3,1,415,185,600
241,2,39,0,1,2,26,46,7,0,0,9,159,32,323,4,1,328,272,600
242,1,32,1,1,4,22,34,11,2,3,15,194,31,351,1,1,353,247,600
243,2,47,1,2,2,33,46,6,2,1,13,171,34,360,2,0,362,238,600
31,0,65,3,0,6,46,72,3,2,1,18,120,58,394,3,2,399,201,600
32,0,45,1,0,3,40,78,4,4,3,16,82,28,304,2,1,307,193,500
33,1,55,3,1,5,43,65,3,5,3,14,112,46,356,1,0,357,207,564
34,1,51,1,1,3,41,72,6,1,1,9,90,28,305,4,0,309,191,500
35,3,61,3,1,2,34,62,3,0,1,20,78,37,305,3,0,308,192,500
36,1,51,0,2,0,38,64,2,3,3,18,85,40,307,2,0,309,191,500
37,2,50,0,1,6,40,70,2,6,3,19,80,36,315,2,2,319,181,500
38,1,57,2,1,4,50,56,5,3,0,27,109,44,359,4,0,363,237,600
39,2,63,4,1,3,56,45,1,4,6,21,128,47,381,8,0,389,211,600
40,0,64,2,0,4,50,73,4,4,3,19,104,60,387,8,0,395,205,600
63,1,75,1,1,0,43,53,5,1,2,5,34,53,274,3,0,277,223,500
66,2,83,4,1,4,42,86,2,2,3,17,75,73,394,0,0,394,206,600
70,1,94,2,1,3,51,75,6,3,2,21,90,68,417,4,0,421,179,600
80,0,94,1,0,2,51,78,2,1,2,19,59,90,399,6,0,405,195,600
132,1,136,1,3,6,37,88,3,4,4,7,71,91,452,1,0,453,147,600
133,1,134,2,1,4,42,92,3,0,3,8,65,92,447,3,0,450,150,600
134,0,125,0,1,7,37,86,5,6,1,12,72,93,445,2,0,447,153,600
135,0,107,2,1,5,35,83,2,2,3,14,72,77,403,0,0,403,131,534
136,1,96,0,0,4,29,76,1,3,0,10,64,76,360,1,0,361,139,500
137,0,104,1,1,5,46,75,3,2,2,15,33,82,369,4,1,374,126,500
138,1,90,0,0,3,29,72,1,4,2,13,61,98,374,1,0,375,125,500
139,0,97,2,0,0,25,73,4,4,2,9,61,91,368,1,0,369,131,500
140,0,136,0,0,4,42,97,1,4,1,8,92,84,469,1,0,470,130,600
151,1,114,1,1,5,30,66,6,4,0,12,55,62,357,1,1,359,141,500
159,0,112,1,1,6,21,85,6,5,1,6,38,144,426,1,0,427,173,600
161,0,97,1,0,1,31,79,7,0,0,8,51,129,404,0,0,404,176,580
163,0,52,0,1,3,26,64,1,3,3,16,92,41,302,3,0,305,145,450
166,0,30,1,1,0,8,29,7,2,0,7,170,27,282,6,0,288,312,600
170,0,37,1,0,1,19,23,3,3,1,4,138,26,256,6,0,262,338,600
173,0,33,1,0,0,17,29,3,1,0,5,128,26,243,5,1,249,301,550
181,0,87,0,0,1,42,101,9,3,0,7,33,135,418,2,1,421,179,600
184,1,85,1,0,2,33,116,3,0,1,10,32,140,424,2,0,426,174,600
186,0,72,0,2,1,21,93,6,1,1,7,26,103,333,1,1,335,165,500
187,0,106,2,2,3,46,73,2,3,3,10,63,108,421,2,0,423,177,600
190,0,94,0,2,4,48,100,8,4,2,11,48,97,418,0,0,418,182,600
197,1,86,0,2,2,45,101,1,4,0,6,61,127,436,0,0,436,164,600
198,0,83,2,0,7,40,100,1,6,1,9,67,102,418,4,0,422,178,600
199,0,90,1,0,1,43,103,6,4,0,16,62,111,437,2,2,441,159,600
200,1,101,1,0,2,30,85,2,4,1,13,53,121,414,1,1,416,184,600
211,0,90,0,1,2,46,85,4,5,2,17,63,108,423,0,1,424,176,600
212,1,114,1,0,2,36,83,3,7,0,6,76,105,434,0,0,434,166,600
213,1,106,0,0,3,37,115,3,6,0,14,56,110,451,0,0,451,149,600
214,1,81,3,4,7,38,101,3,2,1,11,50,128,430,6,1,437,163,600
215,1,88,3,0,0,31,98,1,2,0,19,66,102,411,1,0,412,188,600
216,0,96,1,0,2,26,79,1,7,0,11,43,101,367,1,0,368,138,506
217,0,86,1,1,3,19,89,2,6,0,13,50,98,368,2,0,370,130,500
218,0,83,2,0,0,20,71,5,3,3,6,30,82,305,2,0,307,193,500
219,1,50,1,1,4,36,48,6,2,4,10,169,34,366,5,2,373,227,600
220,1,46,1,1,2,38,50,5,9,6,11,164,32,366,2,0,368,232,600
221,1,62,1,2,2,37,45,3,3,2,20,159,39,376,6,0,382,218,600
222,1,45,0,2,2,37,34,4,0,0,11,160,43,339,1,1,341,259,600
223,0,53,1,0,1,21,39,4,0,3,15,155,36,328,8,3,339,261,600
224,0,48,0,3,0,37,51,3,2,1,14,164,42,365,7,1,373,227,600
225,2,46,2,0,1,20,45,4,2,0,11,186,31,350,3,0,353,247,600
226,2,52,2,2,3,44,41,2,1,2,15,170,34,370,1,1,372,228,600
227,0,57,4,1,2,29,59,9,5,1,16,141,36,360,8,1,369,231,600
228,0,48,1,0,3,36,43,6,1,5,21,185,28,377,5,3,385,215,600
229,1,43,2,0,2,32,56,4,2,1,16,154,33,346,3,1,350,250,600
230,1,41,3,0,2,43,31,7,1,2,10,151,35,327,3,4,334,266,600
231,3,41,2,1,3,27,46,4,2,4,16,165,34,348,3,1,352,248,600
232,1,42,1,0,2,24,48,3,3,4,18,151,37,334,2,1,337,262,599
233,1,36,0,0,2,34,49,5,3,0,20,177,44,371,3,0,374,226,600
234,0,36,1,2,4,24,40,4,4,1,21,176,30,343,2,1,346,254,600
235,0,32,1,1,3,31,41,4,2,2,10,190,36,353,5,1,359,241,600
236,1,43,3,1,1,20,42,10,2,2,19,155,27,326,7,0,333,267,600
237,2,45,3,1,3,27,33,3,5,6,18,175,31,352,0,0,352,248,600
238,4,48,0,0,3,26,51,3,3,3,11,164,38,354,1,1,356,244,600
239,2,37,1,0,2,24,49,7,6,1,19,168,33,349,5,1,355,245,600
240,0,43,1,0,2,27,31,8,3,2,18,166,41,342,8,1,351,248,599
244,0,58,3,2,1,23,43,9,3,2,18,169,24,355,2,0,357,243,600
245,1,39,0,1,4,22,57,3,1,1,13,165,32,339,5,0,344,256,600
246,1,58,4,2,1,22,50,8,3,0,11,167,46,373,6,1,380,220,600
247,0,49,2,1,6,30,45,3,4,2,17,172,40,371,4,2,377,223,600
248,0,52,1,1,6,28,42,3,4,4,20,157,34,352,3,1,356,244,600
249,0,47,0,0,3,22,54,7,0,3,22,151,22,331,8,0,339,261,600
250,3,34,2,0,0,34,35,6,0,2,11,146,35,308,3,0,311,237,548
251,0,43,5,1,3,34,42,8,0,1,14,137,28,316,5,0,321,179,500
252,1,50,1,0,3,21,39,4,5,3,10,142,32,311,2,1,314,186,500
253,0,30,1,1,1,19,38,3,5,1,10,142,29,280,5,0,285,215,500
254,1,97,1,2,2,33,88,4,5,2,14,98,113,460,3,1,464,136,600
255,1,104,2,0,1,43,95,5,3,0,18,88,96,456,2,0,458,142,600
256,0,126,1,0,1,26,84,5,9,0,8,89,95,444,2,0,446,154,600
257,0,100,2,0,5,43,79,1,3,0,11,69,112,425,4,1,430,170,600
258,0,126,1,0,6,37,63,8,0,2,7,93,108,451,0,0,451,149,600
259,1,123,1,0,4,42,83,3,8,4,7,68,94,438,1,1,440,160,600
260,1,104,0,0,1,51,90,7,6,5,11,77,90,443,0,1,444,156,600
261,0,96,2,0,6,33,83,4,2,0,9,66,87,388,0,0,388,133,521
262,0,112,0,0,1,37,64,4,3,3,11,69,73,377,0,1,378,122,500
263,2,98,2,0,1,26,57,7,6,2,12,91,82,386,0,1,387,113,500
264,1,70,5,1,2,36,67,3,1,1,28,117,33,365,6,0,371,229,600
265,1,58,0,0,3,47,51,7,3,1,15,138,38,362,8,0,370,230,600
266,3,58,1,1,0,49,41,1,4,3,29,146,47,383,6,0,389,211,600
267,4,59,1,1,0,38,60,4,1,2,27,129,35,361,9,1,371,229,600
268,1,57,1,1,4,56,60,5,4,1,19,140,45,394,6,0,400,200,600
269,2,60,1,2,0,38,57,3,1,3,13,152,39,371,2,2,375,225,600
270,1,59,0,0,1,35,57,8,3,1,26,121,42,354,5,0,359,241,600
271,0,53,1,0,0,43,63,3,2,3,16,133,51,368,2,1,371,229,600
272,0,68,0,1,1,44,56,10,3,2,25,136,38,384,4,0,388,212,600
273,1,44,2,0,3,40,67,5,3,3,28,126,45,367,4,0,371,229,600
274,1,57,2,0,5,49,53,2,3,1,10,169,32,384,3,1,388,212,600
275,0,57,1,0,3,35,44,3,1,4,28,146,44,366,8,2,376,224,600
276,1,53,1,0,1,51,51,7,2,1,26,144,55,393,6,0,399,201,600
277,2,69,1,3,2,34,46,2,2,1,35,135,41,373,7,0,380,210,590
278,1,34,3,1,5,41,57,9,2,1,29,117,48,348,4,1,353,197,550
279,3,65,1,0,2,38,40,6,0,0,28,140,24,347,7,0,354,196,550
280,1,2,0,1,3,1,10,0,0,1,1,1,2,23,3,0,26,96,122
281,0,123,1,2,2,46,78,2,5,3,24,72,57,415,2,1,418,182,600
282,2,95,1,0,6,50,74,1,2,1,29,100,53,414,5,1,420,180,600
283,1,88,0,0,3,39,72,6,4,2,24,111,60,410,1,0,411,189,600
284,0,96,3,1,3,42,72,4,4,2,14,98,66,405,2,1,408,192,600
285,0,93,2,2,5,44,79,3,4,2,22,105,55,416,5,0,421,179,600
286,2,83,1,0,2,42,84,7,2,2,21,105,58,409,1,1,411,189,600
287,2,89,1,3,2,50,74,1,7,4,18,81,84,416,4,0,420,180,600
288,1,94,3,0,3,44,58,4,5,7,19,107,59,404,3,2,409,191,600
289,4,102,2,2,6,46,75,4,1,2,17,115,61,437,1,0,438,162,600
290,1,99,3,1,1,44,71,4,6,4,22,89,73,418,1,0,419,181,600
291,1,81,1,1,2,56,75,5,2,1,17,91,62,395,1,1,397,203,600
292,0,99,3,0,3,39,76,0,2,3,23,97,55,400,1,1,402,198,600
293,0,104,2,2,0,48,76,3,5,4,14,95,61,414,5,0,419,181,600
294,0,92,1,1,3,43,90,8,4,1,12,80,48,383,5,0,388,212,600
295,2,96,2,0,3,36,67,3,5,1,13,118,65,411,2,0,413,187,600
296,1,99,1,0,0,52,71,2,5,0,22,100,41,394,3,0,397,203,600
297,1,84,0,0,8,52,74,5,9,4,21,89,61,408,3,0,411,189,600
298,1,101,2,1,10,40,60,4,2,1,20,104,48,394,3,0,397,203,600
299,3,90,1,1,4,53,75,3,2,1,24,89,60,406,1,1,408,192,600
300,0,100,1,2,1,51,64,3,6,4,14,93,73,412,3,0,415,185,600
301,1,112,1,0,3,37,73,4,4,1,22,97,47,402,2,0,404,196,600
302,3,122,2,2,4,48,63,3,5,1,29,97,54,433,3,0,436,164,600
303,1,94,2,3,2,56,58,7,4,0,20,94,63,404,4,2,410,190,600
304,1,98,3,0,3,48,67,1,5,4,20,111,48,409,0,1,410,190,600
305,1,96,2,0,6,45,83,1,3,5,15,106,62,425,4,0,429,171,600
306,2,100,3,3,7,36,68,4,3,1,20,78,49,374,2,0,376,163,539
307,1,96,0,2,6,29,61,2,1,0,17,80,41,336,2,0,338,162,500
308,2,71,1,1,2,42,67,1,1,1,17,80,55,341,2,0,343,157,500
309,1,91,2,1,3,46,63,3,1,4,15,76,39,345,3,0,348,152,500
310,1,50,0,0,3,29,53,4,1,2,21,135,34,333,5,0,338,262,600
311,1,53,3,0,1,36,44,3,5,1,21,135,31,334,7,0,341,259,600
312,0,47,2,0,5,40,58,4,0,1,17,120,27,321,3,2,326,274,600
313,2,57,2,1,3,26,60,11,1,3,24,121,41,352,6,1,359,241,600
314,2,61,1,1,4,23,68,8,1,1,12,120,24,326,1,0,327,273,600
315,2,41,4,1,2,27,50,9,2,0,21,119,38,316,4,1,321,279,600
316,5,46,0,1,2,30,48,1,2,4,10,112,44,305,3,1,309,231,540
317,6,37,2,0,1,23,44,4,2,2,10,109,36,276,4,1,281,219,500
318,0,41,2,1,2,22,55,2,1,2,11,103,28,270,1,0,271,229,500
319,0,40,0,1,0,32,63,5,1,2,15,119,27,305,4,0,309,191,500
320,2,57,0,0,4,20,43,5,1,1,5,115,34,287,1,2,290,210,500
321,0,98,0,0,0,47,75,5,2,2,20,111,40,400,3,0,403,197,600
322,3,84,1,1,5,49,65,4,3,5,26,76,61,383,2,0,385,215,600
323,2,93,0,0,2,41,77,4,3,1,16,98,52,389,8,0,397,203,600
324,2,95,3,0,4,39,61,3,5,1,17,82,72,384,5,0,389,211,600
325,1,85,3,0,3,50,60,1,3,1,16,98,62,383,3,1,387,213,600
326,3,80,2,0,3,49,66,5,9,1,20,99,58,395,5,1,401,199,600
327,3,98,0,0,3,41,66,5,2,1,18,103,52,392,1,2,395,205,600
328,0,90,4,1,4,45,55,6,2,2,20,113,52,394,4,1,399,201,600
329,3,88,2,1,9,41,67,4,3,0,11,112,60,401,3,0,404,196,600
330,1,98,0,0,2,38,66,2,5,1,25,98,45,381,1,1,383,217,600
331,2,94,2,0,3,37,64,4,3,4,28,110,43,394,4,0,398,202,600
332,1,85,2,0,0,50,78,1,3,1,18,94,59,392,1,2,395,205,600
333,1,106,2,0,1,50,55,3,3,4,13,110,65,413,7,0,420,180,600
334,2,82,1,1,2,64,76,4,3,3,17,89,45,389,4,0,393,207,600
335,4,79,1,2,5,40,70,3,6,2,15,99,69,395,3,0,398,202,600
336,0,100,0,1,2,36,57,2,4,3,16,103,57,381,1,0,382,218,600
337,0,78,1,0,4,31,68,6,5,3,17,111,50,374,1,0,375,225,600
338,2,77,2,0,4,39,56,3,1,2,19,150,59,414,1,0,415,185,600
339,0,88,2,1,2,48,72,6,4,3,10,115,56,407,2,0,409,191,600
340,0,87,2,0,4,49,70,5,5,1,27,89,68,407,1,0,408,192,600
341,0,87,1,2,2,38,80,1,2,2,16,110,58,399,5,2,406,194,600
342,1,99,1,2,5,37,53,4,0,2,23,118,60,405,1,1,407,193,600
343,4,92,3,0,7,50,61,1,3,5,20,99,58,403,3,1,407,193,600
344,2,95,1,0,0,37,45,2,4,2,19,88,53,348,0,1,349,194,543
345,3,67,1,0,2,46,60,2,5,2,14,98,40,340,1,0,341,159,500
346,1,72,1,0,1,31,53,2,2,4,18,100,49,334,2,0,336,164,500
347,1,79,1,1,3,35,53,7,2,2,12,95,52,343,1,0,344,156,500
348,4,55,1,0,1,40,62,2,2,0,16,135,51,369,1,1,371,229,600
349,4,53,1,0,1,54,46,2,1,3,21,158,38,382,7,0,389,211,600
350,0,73,1,1,2,61,47,4,2,0,14,129,46,380,4,1,385,215,600
351,0,53,1,2,2,43,62,1,4,5,20,171,37,401,7,0,408,192,600
352,0,52,2,1,0,34,42,4,4,3,21,142,55,360,2,0,362,188,550
353,0,42,2,4,3,26,40,4,3,3,18,120,32,297,1,0,298,202,500
354,3,47,0,1,0,23,37,2,1,4,23,142,29,312,1,0,313,187,500
355,1,56,0,1,1,26,48,4,4,1,19,142,31,334,6,0,340,160,500
356,1,44,0,1,2,26,37,7,3,2,23,133,31,310,3,0,313,187,500
357,2,96,1,2,4,38,64,7,6,2,19,134,54,429,1,1,431,169,600
358,0,88,2,1,1,35,65,5,0,6,8,129,55,395,7,2,404,196,600
359,2,96,2,4,0,49,65,3,3,1,14,134,53,426,0,0,426,174,600
360,1,69,2,1,2,40,79,2,6,0,14,145,65,426,2,1,429,171,600
361,2,79,0,1,4,46,59,2,5,3,20,133,58,412,2,0,414,186,600
362,4,112,2,0,7,35,65,4,3,4,21,101,51,409,7,0,416,184,600
363,2,82,2,0,2,46,69,1,6,1,18,113,72,414,1,3,418,182,600
364,0,70,0,0,3,52,79,4,5,4,15,142,45,419,0,0,419,181,600
365,3,82,3,0,1,37,54,2,3,2,21,110,65,383,1,1,385,215,600
366,0,91,4,1,8,44,61,5,1,1,17,126,57,416,4,0,420,180,600
367,1,81,1,0,2,42,48,6,4,3,20,127,50,385,6,1,392,207,599
368,3,91,5,1,4,48,52,5,2,0,25,104,58,398,5,0,403,197,600
369,1,74,2,1,1,28,62,3,5,3,14,166,39,399,5,1,405,195,600
370,0,88,0,1,2,39,62,8,0,5,15,136,56,412,4,1,417,183,600
371,1,85,1,1,3,46,66,2,3,1,17,107,54,387,0,0,387,213,600
372,0,86,3,0,1,42,60,6,4,4,17,125,53,401,2,0,403,197,600
374,0,92,2,1,2,31,63,3,6,3,14,112,62,391,2,0,393,143,536
375,1,87,1,0,1,27,59,1,7,1,24,79,48,336,2,0,338,162,500
376,1,109,0,0,4,47,62,7,9,2,19,92,73,425,5,0,430,170,600
381,0,95,0,1,3,30,69,6,3,2,22,99,74,404,1,1,406,194,600
382,0,108,0,4,2,44,68,4,7,1,18,104,78,438,1,1,440,160,600
383,1,105,1,0,3,42,75,7,6,4,16,74,89,423,1,1,425,175,600
384,2,99,3,1,5,36,64,10,5,1,17,85,61,389,4,0,393,207,600
385,2,124,2,0,5,34,65,1,8,4,20,90,63,418,5,0,423,177,600
386,0,101,1,0,4,45,63,6,0,3,24,101,66,414,2,0,416,184,600
387,1,104,3,0,7,39,69,4,1,1,13,87,83,412,3,0,415,179,594
388,1,93,1,0,2,36,56,3,7,1,19,76,52,347,1,0,348,152,500
389,0,101,2,2,4,28,46,2,1,1,13,85,58,343,2,0,345,155,500
390,0,74,0,0,2,38,47,3,3,5,15,105,51,343,3,0,346,154,500
391,1,82,3,1,3,36,49,4,5,4,10,86,73,357,1,0,358,142,500
392,2,80,1,2,5,36,51,5,5,0,15,82,51,335,2,0,337,163,500
393,0,99,0,0,4,51,73,3,4,4,22,71,57,388,4,0,392,208,600
394,1,93,2,1,13,65,66,3,1,3,18,101,70,437,3,0,440,160,600
395,1,115,1,0,1,48,53,5,0,1,20,95,57,397,6,0,403,197,600
396,0,83,0,3,6,60,62,2,4,0,17,95,70,402,0,0,402,198,600
397,1,77,0,0,1,47,56,2,3,2,13,111,62,375,2,0,377,223,600
398,0,95,2,1,3,45,73,4,6,2,21,109,58,419,4,2,425,175,600
399,1,79,1,0,4,51,51,4,7,2,13,99,34,346,0,0,346,154,500
400,0,75,1,1,2,35,49,5,5,2,13,82,54,324,1,1,326,174,500
401,2,86,1,1,3,37,47,2,3,5,14,89,51,341,2,0,343,157,500
402,1,55,1,1,1,37,52,2,1,2,24,87,50,314,3,0,317,183,500
403,0,85,0,0,6,40,56,3,2,1,11,72,57,333,3,0,336,175,511
404,1,94,1,0,5,47,67,1,3,0,14,97,66,396,8,1,405,195,600
405,2,94,0,0,3,55,60,9,6,1,20,89,71,410,3,0,413,187,600
406,0,114,2,2,5,30,72,5,3,3,27,94,55,412,4,0,416,184,600
407,0,112,1,3,3,30,56,3,2,1,27,98,64,400,1,0,401,194,595
408,0,80,3,1,3,28,73,2,0,3,11,86,63,353,2,0,355,145,500
409,1,88,2,0,5,53,56,3,3,2,29,73,45,360,4,0,364,136,500
410,0,123,0,0,4,45,88,5,3,2,19,52,105,446,2,0,448,152,600
411,2,103,0,0,6,46,78,2,2,1,20,68,83,411,5,0,416,184,600
412,0,110,2,1,6,33,82,4,2,1,15,60,99,415,5,1,421,179,600
413,1,113,0,0,2,41,84,6,2,4,17,52,98,420,2,0,422,178,600
414,1,100,2,0,1,44,95,2,3,2,15,60,94,419,2,1,422,178,600
415,1,100,1,2,1,34,103,3,3,2,19,54,116,439,0,0,439,161,600
416,1,79,2,1,5,40,111,5,5,2,16,66,92,425,1,0,426,174,600
417,0,100,0,0,2,27,102,3,1,2,15,78,115,445,3,2,450,150,600
418,0,80,0,1,1,36,81,8,4,4,11,80,107,413,2,0,415,185,600
419,2,92,1,3,5,41,94,8,10,1,13,56,109,435,5,0,440,160,600
420,0,90,1,0,2,37,81,7,3,0,21,56,129,427,2,1,430,170,600
421,1,113,0,1,5,58,94,1,4,4,20,51,87,439,4,0,443,157,600
422,4,124,1,1,3,40,62,4,6,5,23,86,90,449,0,0,449,151,600
423,2,100,1,1,4,41,79,2,1,3,21,64,101,420,3,0,423,177,600
424,1,100,1,0,4,40,89,7,2,5,15,61,89,414,0,0,414,186,600
425,0,106,3,1,3,46,88,4,7,1,14,56,104,433,2,0,435,165,600
426,3,96,2,1,6,35,81,4,2,4,14,74,111,433,1,1,435,165,600
427,3,100,3,4,2,36,81,7,4,1,21,69,98,429,5,1,435,165,600
428,1,97,0,1,7,37,89,10,5,1,19,65,107,439,4,0,443,157,600
429,0,81,0,0,2,27,73,3,3,4,15,37,115,360,1,0,361,139,500
430,3,93,0,0,4,27,76,1,3,1,6,43,83,340,2,1,343,127,470
431,3,95,2,1,5,34,58,4,8,5,25,103,58,401,3,1,405,195,600
432,3,84,0,2,7,41,74,2,2,4,27,73,86,405,3,1,409,191,600
433,1,111,0,1,11,37,67,5,6,3,18,67,84,411,3,0,414,186,600
434,4,131,0,3,4,31,71,4,0,1,20,72,82,423,2,0,425,175,600
435,2,109,1,2,2,43,72,7,2,1,25,72,89,427,4,0,431,169,600
441,2,98,3,1,6,37,63,8,3,4,33,67,83,408,4,0,412,188,600
442,2,91,4,2,2,43,68,6,1,3,28,88,63,401,9,0,410,190,600
443,1,95,0,1,2,38,70,7,1,2,27,99,67,410,1,0,411,189,600
444,1,122,0,1,0,41,79,4,4,3,14,85,68,422,3,0,425,175,600
445,1,114,0,1,5,33,71,8,3,4,18,91,81,430,3,0,433,167,600
446,2,99,1,0,2,42,78,5,3,4,12,84,96,428,5,1,434,166,600
447,2,95,0,1,0,35,81,8,6,2,23,120,63,436,3,1,440,160,600
448,4,120,1,0,2,34,60,5,5,2,14,107,55,409,1,0,410,190,600
449,2,112,0,1,1,39,89,4,6,2,15,76,80,427,1,0,428,172,600
450,0,109,0,0,2,40,58,6,3,5,15,69,64,371,7,0,378,171,549
451,1,52,1,0,3,34,83,6,4,5,24,58,47,318,3,2,323,221,544
452,0,105,0,0,7,34,81,6,1,4,26,67,55,386,6,0,392,208,600
453,4,103,0,0,3,40,66,2,0,3,27,77,65,390,2,0,392,208,600
454,4,77,1,1,3,46,55,3,3,2,26,70,46,337,1,0,338,212,550
455,1,71,0,0,4,53,52,7,5,1,18,52,46,310,1,1,312,188,500
457,0,71,0,2,1,26,128,8,0,0,11,43,178,468,2,0,470,130,600
458,0,48,1,1,4,24,124,4,1,3,9,39,170,428,1,0,429,171,600
459,0,90,0,2,2,18,102,2,0,0,7,34,186,443,0,0,443,157,600
460,0,69,1,1,1,24,112,5,6,0,7,32,185,443,0,0,443,157,600
461,0,61,1,1,0,23,125,3,2,1,5,19,190,431,6,0,437,163,600
462,1,66,1,0,2,23,110,7,5,3,7,27,186,438,3,1,442,158,600
463,0,60,1,1,2,16,123,3,1,0,7,33,186,433,0,0,433,167,600
464,0,81,0,0,2,16,129,6,2,0,4,28,158,426,1,0,427,173,600
465,2,76,1,0,1,17,125,9,3,0,4,24,167,429,0,0,429,171,600
466,0,69,0,1,0,28,134,5,1,0,7,37,146,428,6,2,436,164,600
467,0,58,0,1,1,22,131,5,0,1,2,19,195,435,3,0,438,162,600
468,0,79,2,1,0,30,107,3,3,0,1,26,181,433,2,0,435,165,600
469,1,85,1,1,1,31,118,2,0,3,8,18,134,403,2,1,406,150,556
470,0,57,2,1,4,20,94,7,0,0,2,31,130,348,2,0,350,150,500
471,0,52,0,1,2,29,120,1,3,0,9,25,122,364,2,0,366,134,500
472,0,61,0,2,3,19,93,2,2,2,3,25,135,347,0,0,347,153,500
473,1,81,0,0,1,28,118,2,4,1,13,61,159,469,4,1,474,126,600
474,0,84,2,0,1,34,116,4,3,0,3,38,177,462,0,0,462,138,600
475,0,92,0,0,3,25,117,2,5,0,6,50,149,449,3,0,452,148,600
476,0,78,1,2,3,28,118,1,2,0,4,39,161,437,3,1,441,159,600
477,0,68,3,0,3,34,116,6,9,0,10,39,147,435,2,1,438,162,600
373,0,97,0,1,3,58,64,2,2,4,21,117,63,432,4,0,436,164,600
377,0,123,1,1,2,42,84,5,3,1,15,80,83,440,3,0,443,157,600
378,0,104,0,1,2,45,59,3,1,2,12,110,84,423,0,0,423,177,600
379,1,88,2,1,6,51,47,7,1,1,10,119,76,410,2,0,412,188,600
380,0,102,1,1,7,47,77,5,0,4,15,99,53,411,5,1,417,183,600
436,2,108,2,0,4,32,62,9,7,2,25,99,71,423,1,2,426,174,600
437,2,112,1,2,4,32,65,3,1,2,26,85,62,397,2,0,399,201,600
438,1,100,0,3,5,44,70,8,8,3,27,73,81,423,4,0,427,173,600
439,5,92,1,0,3,38,58,7,6,3,11,102,73,399,3,0,402,198,600
440,4,96,1,0,3,41,67,5,4,6,16,56,88,387,1,1,389,211,600
456,1,84,0,0,1,41,75,3,4,3,14,51,40,317,1,0,318,182,500
478,1,76,0,0,0,25,108,1,4,1,5,44,162,427,1,0,428,172,600
479,0,82,0,1,0,25,117,8,4,1,10,35,163,446,6,0,452,148,600
480,1,82,0,1,0,26,133,5,4,0,5,39,161,457,0,1,458,142,600
481,0,107,0,1,3,34,110,7,7,2,11,44,148,474,1,0,475,136,611
482,0,72,2,1,3,27,107,7,4,2,8,56,162,451,3,0,454,156,610
483,2,75,0,0,0,23,95,5,2,0,19,65,124,410,1,0,411,189,600
484,0,96,0,0,5,30,98,7,1,1,14,75,104,431,5,0,436,164,600
485,1,97,1,1,1,34,79,6,4,0,19,47,149,439,1,0,440,160,600
486,0,113,1,2,2,32,81,9,5,3,13,51,119,431,4,0,435,165,600
487,0,83,0,2,5,31,87,7,2,0,9,52,116,394,0,0,394,156,550
488,1,104,0,0,2,25,75,14,0,0,9,54,95,379,1,0,380,170,550
489,2,81,0,1,3,33,81,5,2,2,12,65,88,375,0,0,375,146,521
490,0,7,0,0,0,0,26,1,0,1,0,2,5,42,1,0,43,17,60
491,0,105,2,0,7,46,96,4,4,3,26,82,67,442,1,0,443,157,600
492,0,95,4,0,2,31,96,5,3,2,13,103,93,447,3,2,452,148,600
493,0,102,2,2,3,38,78,4,2,0,19,81,90,421,4,0,425,175,600
494,1,112,3,1,3,40,94,3,3,4,13,83,80,440,4,0,444,156,600
495,1,108,1,1,4,46,90,2,4,1,19,87,68,432,5,1,438,162,600
496,2,119,2,1,3,42,111,3,8,4,9,73,64,441,0,0,441,159,600
497,2,115,4,0,1,36,104,4,7,1,12,83,86,455,0,1,456,144,600
500,0,112,2,0,2,40,106,2,2,1,24,84,81,456,2,0,458,142,600
501,1,110,3,3,2,47,85,4,2,2,9,80,70,418,3,2,423,177,600
503,1,117,2,0,2,42,81,5,2,2,11,98,80,443,1,0,444,156,600
504,1,91,0,0,1,44,90,1,3,2,19,87,83,422,2,0,424,176,600
505,1,110,2,0,5,49,83,2,3,0,21,79,89,444,0,0,444,156,600
506,3,99,0,0,4,25,95,4,4,0,20,66,67,387,3,1,391,109,500
507,2,80,1,2,5,37,66,2,1,1,12,59,71,339,2,0,341,139,480
508,3,91,0,3,2,42,67,1,4,2,22,115,64,416,3,1,420,180,600
509,0,91,2,0,6,25,58,14,7,2,21,112,54,392,1,0,393,207,600
510,1,95,1,2,3,53,56,6,3,5,21,109,65,420,6,0,426,174,600
511,0,114,1,2,1,40,52,2,6,1,19,107,59,404,4,0,408,192,600
512,1,110,4,0,5,40,51,3,6,2,19,127,43,411,6,0,417,183,600
513,1,110,3,1,1,34,62,1,3,2,16,103,63,400,1,0,401,199,600
514,0,92,1,0,2,47,77,4,6,3,15,112,64,423,2,1,426,174,600
515,1,96,5,0,5,37,67,3,5,1,28,88,70,406,4,0,410,190,600
516,0,107,5,1,4,47,77,7,3,3,23,109,53,439,1,0,440,160,600
517,1,112,0,2,7,30,71,2,5,6,20,93,51,400,3,1,404,196,600
518,0,89,0,0,3,43,81,0,3,3,16,104,62,404,2,0,406,194,600
519,0,93,1,0,4,37,58,5,1,1,15,114,55,384,2,0,386,214,600
520,1,93,1,3,4,44,59,4,1,4,28,101,55,398,0,0,398,202,600
521,2,87,4,2,5,36,89,3,5,1,11,114,49,408,2,0,410,190,600
522,2,82,3,2,4,47,69,4,6,1,22,121,49,412,2,2,416,184,600
523,2,85,3,1,3,39,59,4,4,4,19,127,48,398,5,0,403,197,600
524,2,101,0,0,0,47,42,5,0,2,17,132,60,408,5,0,413,187,600
525,1,114,3,1,2,35,50,12,3,4,19,104,71,419,5,2,426,174,600
526,3,101,0,0,3,28,70,4,4,4,17,101,67,402,1,0,403,197,600
527,1,97,0,0,2,34,57,5,2,4,14,99,66,381,6,0,387,213,600
528,5,108,3,0,4,31,54,6,2,3,24,115,59,414,4,0,418,182,600
529,1,114,1,0,8,36,63,6,4,1,16,121,58,429,1,1,431,169,600
530,2,101,3,2,3,25,86,1,1,4,18,89,73,408,4,0,412,188,600
531,2,97,4,0,4,25,65,1,4,4,10,109,39,364,5,0,369,174,543
532,2,94,2,0,4,57,52,3,7,2,19,128,49,419,0,1,420,180,600
533,2,110,0,0,5,41,58,5,2,2,19,113,50,407,4,1,412,188,600
534,1,91,0,1,6,34,47,4,5,1,29,133,56,408,3,1,412,188,600
535,0,121,1,0,4,40,73,1,4,3,16,123,52,438,5,0,443,157,600
536,3,87,1,0,4,35,63,3,2,2,21,117,44,382,6,0,388,212,600
537,1,96,1,0,5,46,45,6,5,4,22,134,65,430,2,0,432,168,600
538,3,99,0,2,2,60,58,6,2,2,16,119,57,426,2,0,428,172,600
539,1,92,2,0,0,44,81,2,4,1,17,129,53,426,1,1,428,172,600
540,3,116,4,2,5,32,68,2,5,2,12,131,50,432,3,0,435,165,600
541,3,84,0,0,3,40,91,2,6,1,17,115,40,402,2,1,405,181,586
542,0,94,0,1,1,26,61,1,1,1,13,108,45,352,15,0,367,133,500
543,1,2,1,1,1,7,9,0,2,0,5,0,3,32,5,0,37,39,76
544,1,64,0,0,4,33,43,5,2,4,20,142,57,375,0,0,375,225,600
545,1,95,0,0,3,32,49,4,5,1,17,126,50,383,4,0,387,213,600
546,1,69,2,1,1,49,89,3,7,1,16,117,43,399,3,0,402,198,600
547,3,74,1,1,4,37,55,5,3,1,23,163,57,427,0,1,428,172,600
548,1,94,1,0,4,32,55,4,5,2,15,125,54,392,3,1,396,204,600
549,0,82,1,0,0,41,59,7,1,0,22,111,65,389,1,0,390,210,600
550,0,80,2,1,5,26,60,5,3,0,15,132,64,393,3,0,396,204,600
551,1,98,0,2,2,24,61,2,1,4,11,119,50,375,1,1,377,223,600
552,0,85,1,0,2,40,63,3,2,3,10,117,54,380,1,1,382,218,600
553,1,93,1,1,3,39,83,6,1,2,12,102,51,395,3,0,398,202,600
554,1,82,0,2,2,35,53,3,3,1,20,160,48,410,2,1,413,187,600
555,2,95,0,0,2,29,75,10,2,2,18,124,47,406,1,0,407,193,600
556,2,88,2,1,1,28,66,4,5,1,16,124,51,389,2,0,391,209,600
557,0,103,1,1,3,27,51,4,2,2,19,135,42,390,3,0,393,207,600
558,0,94,1,1,3,23,43,1,3,1,7,111,50,338,2,0,340,195,535
559,0,73,0,0,5,28,128,2,1,3,18,50,32,340,4,2,346,123,469
560,1,71,1,1,5,27,83,2,6,2,19,61,19,298,3,0,301,149,450
561,1,84,1,0,1,37,61,5,3,1,17,128,42,381,4,0,385,215,600
562,2,72,1,1,2,32,81,5,0,1,20,117,36,370,2,0,372,228,600
563,1,92,1,0,2,40,48,5,1,2,30,120,51,393,5,0,398,202,600
564,1,84,2,2,1,23,62,5,2,2,16,147,50,397,4,0,401,199,600
565,3,82,0,1,2,43,64,8,1,2,27,147,48,428,2,0,430,170,600
566,1,61,1,0,3,43,69,1,5,2,20,129,44,379,3,0,382,218,600
567,0,80,1,0,1,32,67,7,3,3,21,144,39,398,7,1,406,194,600
568,0,70,0,0,3,34,46,7,4,4,13,139,43,363,1,0,364,186,550
569,0,66,0,2,1,32,69,4,3,3,25,143,20,368,1,0,369,181,550
570,3,81,0,0,0,42,87,0,0,3,19,110,24,369,2,2,373,177,550
571,1,70,2,1,1,28,47,7,2,5,18,131,38,351,7,1,359,191,550
572,1,85,0,1,5,24,34,4,3,1,15,144,43,360,1,0,361,189,550
573,0,69,1,1,1,37,50,4,2,1,23,140,26,355,2,0,357,193,550
574,1,56,2,0,2,25,65,3,3,0,24,133,48,362,1,1,364,186,550
575,2,63,2,0,1,25,71,4,2,2,17,148,41,378,7,1,386,164,550
576,1,69,1,1,3,29,51,7,3,3,13,135,34,350,4,0,354,182,536
577,1,2,0,0,0,7,42,0,1,0,6,19,0,78,0,0,78,13,91
578,4,63,3,0,0,34,80,3,3,1,39,131,38,399,4,0,403,197,600
579,1,82,1,0,3,34,80,5,5,1,32,100,53,397,9,0,406,194,600
580,0,60,0,2,3,22,75,4,3,2,24,92,70,357,3,0,360,163,523
581,0,67,2,0,0,31,86,2,1,2,38,90,43,362,5,0,367,133,500
582,1,68,1,0,2,29,59,1,2,0,27,103,36,329,4,0,333,167,500
583,0,65,1,1,1,30,96,3,0,5,30,82,43,357,1,0,358,142,500
584,0,29,1,0,0,9,20,0,0,1,12,29,17,118,0,0,118,54,172
585,1,61,4,0,3,28,47,4,1,3,17,82,38,289,3,1,293,157,450
586,2,69,4,2,1,30,54,5,5,0,20,93,24,309,3,1,313,148,461
587,4,77,1,0,3,31,59,8,2,3,22,152,30,392,4,0,396,204,600
588,2,66,0,1,5,45,41,3,6,3,25,149,43,389,6,0,395,205,600
589,1,62,1,1,3,30,71,3,2,4,23,159,28,388,2,1,391,209,600
590,1,58,0,0,3,39,58,8,2,2,35,164,27,397,4,0,401,199,600
592,3,52,0,0,2,32,61,4,3,0,40,156,49,402,2,0,404,196,600
593,1,65,0,3,0,31,35,5,3,4,25,132,30,334,3,0,337,163,500
594,3,59,0,0,1,34,34,3,2,1,26,116,27,306,1,0,307,193,500
595,1,58,0,0,1,26,35,3,1,3,31,128,25,312,2,0,314,164,478
596,3,85,1,1,3,34,67,13,4,2,21,101,45,380,3,1,384,216,600
597,2,79,1,0,2,40,68,2,1,0,18,139,53,405,1,0,406,194,600
598,1,75,1,1,1,54,56,10,2,1,13,112,46,373,4,0,377,223,600
599,0,78,1,1,0,45,51,7,4,0,22,105,57,371,1,0,372,228,600
600,2,99,0,1,4,47,51,4,4,2,31,79,88,412,4,0,416,184,600
601,0,93,3,1,5,37,66,5,0,1,31,93,68,403,2,0,405,195,600
602,1,96,2,2,1,41,58,1,2,4,19,103,59,389,2,0,391,209,600
603,3,85,0,3,9,46,63,6,5,2,32,89,36,379,4,0,383,217,600
604,1,79,0,4,3,50,56,2,0,6,24,102,67,394,4,2,400,200,600
605,4,83,2,2,1,44,49,5,2,2,26,116,46,382,4,0,386,214,600
606,4,87,1,2,1,36,42,3,6,1,33,109,54,379,2,0,381,219,600
607,1,78,0,0,3,57,50,7,2,6,22,122,56,404,0,0,404,196,600
608,3,70,0,1,6,31,65,4,4,1,23,107,69,384,1,0,385,215,600
609,1,62,0,2,0,59,50,4,1,0,26,90,67,362,3,0,365,235,600
610,3,62,1,0,3,32,46,6,1,3,25,124,49,355,3,0,358,242,600
611,3,70,2,0,1,45,67,9,1,3,15,115,51,382,3,3,388,212,600
612,0,76,2,1,1,45,58,3,6,3,22,90,70,377,6,0,383,217,600
613,0,71,2,0,0,42,53,6,4,5,23,131,62,399,4,0,403,197,600
614,1,89,0,3,1,39,72,10,0,3,19,100,52,389,2,0,391,209,600
615,3,85,0,0,1,49,70,3,6,5,29,101,56,408,1,0,409,191,600
616,0,66,2,5,5,33,70,1,2,1,20,85,48,338,2,1,341,159,500
617,1,71,0,0,0,32,49,6,1,2,12,75,48,297,1,0,298,199,497
618,4,99,1,0,2,41,83,6,3,2,21,104,49,415,2,0,417,183,600
619,3,121,0,1,5,25,71,6,1,3,19,99,62,416,2,2,420,180,600
620,3,96,6,0,4,34,65,5,4,0,12,121,67,417,0,0,417,183,600
621,0,85,1,1,5,34,85,3,3,1,20,100,60,398,1,1,400,200,600
622,2,90,3,2,0,37,73,7,4,2,21,104,55,400,1,2,403,197,600
623,3,131,2,0,1,36,63,7,3,2,14,97,64,423,4,0,427,173,600
624,1,97,2,2,3,33,87,7,3,3,25,87,90,440,3,1,444,156,600
625,1,119,0,1,8,24,77,0,5,0,16,110,63,424,1,0,425,175,600
626,0,101,6,1,3,34,79,3,2,3,26,94,60,412,4,1,417,183,600
627,2,105,2,3,2,49,75,5,4,2,14,111,50,424,2,0,426,174,600
628,0,105,6,0,1,30,89,7,8,2,24,94,69,435,1,1,437,163,600
629,1,96,1,1,2,28,97,7,7,3,16,95,67,421,2,0,423,177,600
630,1,86,1,0,5,30,67,2,1,1,16,110,47,367,2,0,369,231,600
631,2,76,4,0,3,40,80,6,3,3,21,96,72,406,2,0,408,192,600
632,2,111,1,1,7,43,64,5,8,4,17,99,71,433,1,0,434,166,600
633,0,96,1,3,2,29,84,4,1,1,21,91,92,425,2,2,429,171,600
634,0,76,0,0,0,50,50,5,1,1,12,83,53,331,1,1,333,167,500
635,1,94,2,0,5,21,56,3,5,0,17,91,75,370,0,0,370,130,500
636,0,88,2,0,3,33,37,0,5,1,5,73,43,290,2,1,293,146,439
637,0,51,0,0,0,1,20,1,1,0,3,33,8,118,0,0,118,254,372
638,0,1,0,0,0,1,6,0,0,0,0,0,2,10,0,0,10,29,39
639,2,0,0,0,0,0,22,0,0,0,1,1,3,29,0,0,29,16,45
640,1,145,4,2,5,34,93,3,5,0,16,57,77,442,2,2,446,154,600
641,2,103,0,0,5,36,96,5,3,3,30,81,94,458,2,0,460,140,600
642,3,135,4,0,8,40,86,6,6,2,21,70,74,455,3,0,458,142,600
643,2,126,0,0,0,36,71,1,3,4,11,86,98,438,4,0,442,158,600
645,0,124,2,1,3,42,107,6,4,3,14,69,85,460,1,1,462,138,600
646,1,119,2,0,3,66,80,1,3,0,15,68,92,450,1,0,451,149,600
647,1,126,4,0,3,41,84,9,5,0,9,75,85,442,3,0,445,155,600
648,1,137,2,1,5,37,84,6,3,1,28,68,75,448,1,0,449,151,600
649,2,126,0,0,4,29,92,5,7,2,21,88,99,475,1,0,476,124,600
650,0,123,1,0,6,31,90,4,2,2,22,71,91,443,3,0,446,154,600
651,0,126,2,1,3,42,68,3,4,3,10,91,72,425,2,1,428,172,600
652,0,101,1,0,2,23,73,2,5,1,16,71,71,366,4,0,370,130,500
653,0,118,0,3,3,22,51,2,1,2,21,75,63,361,0,0,361,139,500
654,1,103,1,0,5,26,66,3,6,0,14,79,67,371,0,0,371,129,500
655,0,121,1,0,3,24,60,3,3,0,7,58,62,342,4,1,347,145,492
656,4,104,0,2,2,32,129,2,2,1,30,52,37,397,6,2,405,210,615
657,3,116,1,0,2,18,161,4,1,4,34,52,46,442,6,2,450,165,615
658,4,106,3,1,4,26,127,3,3,1,37,53,48,416,5,3,424,190,614
659,2,43,1,1,3,14,110,5,1,4,17,31,45,277,4,1,282,172,454
660,1,63,1,0,5,33,140,4,5,0,18,31,41,342,6,0,348,106,454
661,0,29,0,0,0,17,39,2,1,3,19,17,16,143,1,0,144,59,203
662,3,80,2,2,6,48,79,3,4,3,26,108,58,422,0,0,422,178,600
663,3,88,1,0,2,38,98,7,8,0,22,84,65,416,2,2,420,180,600
664,0,120,1,0,1,33,63,3,3,4,22,98,63,411,4,0,415,185,600
665,3,73,1,0,4,31,88,4,1,1,12,64,64,346,3,1,350,150,500
666,0,78,0,1,6,44,51,7,0,1,22,79,59,348,4,0,352,148,500
667,0,67,0,0,1,34,55,3,5,0,27,79,68,339,3,2,344,157,501
668,2,63,0,1,5,43,47,10,2,1,26,117,40,357,0,0,357,243,600
669,2,71,1,0,4,35,61,8,1,2,32,115,47,379,4,1,384,216,600
670,1,67,0,1,7,36,51,7,3,1,22,123,55,374,3,0,377,223,600
671,1,56,1,2,6,29,84,4,4,1,30,110,45,373,4,0,377,223,600
672,2,49,0,0,5,29,66,3,4,3,41,116,42,360,1,0,361,239,600
673,2,65,1,0,2,36,31,9,1,2,20,99,40,308,3,0,311,246,557
674,0,70,0,3,3,30,111,1,3,2,37,23,26,309,3,2,314,114,428
675,1,81,0,1,5,36,102,1,6,2,27,31,33,326,5,0,331,97,428
676,0,81,0,0,2,21,112,1,0,1,35,35,30,318,2,2,322,128,450
677,1,69,1,0,0,14,103,1,3,5,22,41,28,288,6,2,296,109,405
678,0,111,0,1,0,38,122,7,5,2,14,43,18,361,4,0,365,135,500
679,5,96,0,0,1,43,139,3,5,1,8,45,28,374,5,2,381,150,531
680,1,69,2,3,3,36,131,7,2,8,26,20,35,343,5,2,350,124,474
681,1,70,0,0,1,31,110,5,2,1,46,43,45,355,2,0,357,143,500
682,3,72,0,1,5,37,105,4,3,4,17,49,30,330,6,2,338,162,500
683,4,58,1,0,2,25,106,4,1,0,36,46,30,313,7,2,322,154,476
684,1,42,0,0,2,15,81,2,0,0,15,28,15,201,2,0,203,151,354
685,0,4,0,0,1,12,38,3,0,0,6,24,2,90,0,0,90,71,161
686,2,58,0,0,1,29,38,7,1,0,27,52,17,232,2,0,234,118,352
687,3,44,1,0,2,28,50,3,0,1,16,43,19,210,4,2,216,134,350
688,0,10,0,0,0,8,59,1,0,0,4,9,2,93,0,0,93,28,121
689,3,31,0,1,1,22,83,1,1,1,17,16,4,181,1,1,183,37,220
690,0,129,1,0,3,22,73,1,3,3,27,119,66,447,5,0,452,148,600
691,2,152,1,2,2,31,83,3,2,1,20,94,72,465,2,1,468,132,600
692,2,135,3,1,0,39,80,1,2,1,19,110,70,463,8,1,472,128,600
693,1,116,3,0,4,33,73,4,2,4,26,117,62,445,3,1,449,151,600
694,2,57,0,0,0,13,25,2,3,1,12,31,28,174,0,0,174,55,229
695,1,122,1,2,0,37,64,3,4,2,11,104,67,418,2,0,420,180,600
696,1,84,3,0,4,36,56,3,4,2,23,135,62,413,4,1,418,182,600
697,0,86,1,0,1,32,73,7,5,1,13,121,50,390,3,0,393,207,600
698,1,84,1,3,3,49,70,4,0,4,24,131,47,421,1,0,422,178,600
699,2,107,0,3,6,30,52,3,5,2,19,137,57,423,2,0,425,175,600
700,2,89,3,0,2,41,32,7,3,2,23,113,61,378,4,0,382,218,600
701,4,62,1,2,2,37,60,4,2,3,18,100,45,340,0,0,340,160,500
702,0,76,3,0,1,40,47,2,7,0,15,121,41,353,1,1,355,145,500
703,1,68,0,0,3,38,52,5,3,1,11,129,46,357,0,1,358,142,500
704,1,84,1,1,4,34,45,1,3,3,13,115,36,341,4,0,345,155,500
705,4,79,0,0,0,24,35,8,5,1,22,108,50,336,4,0,340,160,500
706,1,78,0,2,4,35,77,5,4,2,14,120,41,383,1,0,384,181,565
707,0,83,0,2,6,51,74,4,3,1,19,114,53,410,2,0,412,188,600
708,1,91,3,1,6,50,60,4,5,5,17,113,65,421,2,0,423,177,600
709,2,100,1,0,2,64,68,3,2,0,17,112,70,441,0,2,443,157,600
710,0,114,1,0,4,37,60,4,1,1,16,117,49,404,3,0,407,193,600
711,2,107,1,1,3,54,62,4,5,1,11,85,66,402,2,3,407,193,600
712,0,93,2,0,1,29,65,3,6,2,15,133,68,417,4,2,423,177,600
713,2,118,4,0,9,45,71,7,4,5,14,101,59,439,3,0,442,158,600
714,2,103,2,1,2,43,58,1,2,3,14,126,64,421,0,0,421,179,600
715,1,122,0,1,1,40,59,7,1,2,19,102,73,428,1,1,430,170,600
716,5,89,1,2,0,41,66,3,2,6,13,138,52,418,1,0,419,181,600
717,0,96,1,1,2,49,82,3,4,3,22,92,49,404,1,0,405,195,600
718,1,104,0,0,4,42,61,3,3,0,19,92,85,414,4,0,418,182,600
719,0,116,2,0,4,38,57,6,2,4,27,101,56,413,8,0,421,179,600
720,0,105,1,1,4,42,69,6,2,1,15,115,63,424,0,0,424,176,600
721,1,66,2,1,1,30,49,2,5,2,7,90,68,324,1,0,325,175,500
722,1,81,2,0,5,32,67,1,0,0,16,89,39,333,2,0,335,165,500
723,0,86,4,0,4,32,55,3,1,0,15,91,41,332,4,0,336,164,500
724,0,103,0,1,2,39,53,2,4,3,24,84,63,378,4,0,382,118,500
725,1,95,1,0,3,35,64,5,2,0,12,93,60,371,3,1,375,158,533
726,1,92,2,0,1,46,82,5,4,4,15,133,61,446,3,0,449,151,600
727,0,93,3,2,5,48,72,3,6,4,17,119,59,431,0,0,431,169,600
728,1,93,4,1,1,33,56,4,6,2,22,119,76,418,2,1,421,179,600
729,0,99,1,0,2,41,68,4,1,1,20,123,63,423,5,0,428,172,600
730,2,109,1,1,2,44,68,7,5,1,22,101,58,421,3,0,424,176,600
731,2,108,0,3,3,46,70,8,0,1,20,129,61,451,4,0,455,145,600
732,0,88,1,1,2,45,57,5,2,1,25,99,54,380,1,0,381,169,550
733,0,82,1,0,3,38,53,4,1,3,17,113,54,369,3,0,372,178,550
734,0,79,3,2,3,41,51,5,2,0,19,87,63,355,3,0,358,137,495
735,5,123,5,0,2,41,84,5,5,2,20,84,58,434,4,0,438,162,600
736,3,94,1,0,4,43,82,4,6,2,22,108,77,446,4,0,450,150,600
737,0,111,4,3,3,44,88,2,10,2,17,96,62,442,2,0,444,156,600
738,1,114,0,0,4,53,85,5,6,1,26,102,64,461,1,0,462,138,600
739,2,104,2,0,3,35,80,5,9,5,12,101,82,440,3,0,443,157,600
740,0,127,0,1,4,49,79,4,0,1,22,84,67,438,3,1,442,158,600
741,4,113,2,0,2,39,81,3,4,2,14,109,66,439,5,1,445,155,600
742,1,106,0,0,4,42,91,3,4,5,20,109,69,454,3,1,458,142,600
743,0,95,2,0,5,34,62,2,4,1,13,87,59,364,0,0,364,136,500
744,1,90,2,1,5,38,58,1,3,2,22,92,56,371,1,0,372,128,500
745,1,90,2,0,6,32,73,3,3,6,17,77,45,355,2,2,359,141,500
746,1,109,2,1,5,30,62,2,4,4,21,77,58,376,1,0,377,123,500
747,1,112,2,0,0,35,77,4,11,2,15,80,57,396,1,1,398,109,507
748,1,119,2,1,4,45,71,6,4,1,15,102,84,455,1,1,457,143,600
749,1,131,2,0,2,42,60,4,0,5,18,108,79,452,2,0,454,146,600
750,3,108,3,1,6,36,68,1,3,1,11,106,99,446,3,1,450,150,600
751,0,112,0,1,5,29,91,4,5,4,12,90,102,455,1,3,459,141,600
752,1,120,2,2,6,41,67,4,6,2,24,89,79,443,1,1,445,155,600
753,1,107,1,1,3,31,61,4,4,5,11,83,60,372,2,0,374,126,500
754,1,93,1,0,2,36,52,6,6,1,10,82,79,369,0,0,369,131,500
755,3,106,3,0,2,28,65,4,3,2,13,69,66,364,0,1,365,135,500
756,1,92,2,0,3,32,64,8,2,2,14,91,74,385,5,0,390,110,500
757,1,128,3,1,5,40,79,4,4,1,11,85,73,435,2,2,439,143,582
758,4,31,1,0,3,24,37,4,2,3,12,163,34,318,5,1,324,276,600
759,3,32,1,1,4,24,66,2,1,2,8,142,29,315,2,1,318,282,600
760,6,24,1,0,3,19,39,4,4,2,18,156,30,306,5,0,311,289,600
761,0,32,2,2,4,22,36,6,1,3,20,150,28,306,4,2,312,288,600
762,4,35,0,0,0,20,38,5,1,1,12,177,20,313,3,0,316,284,600
763,1,32,2,2,4,25,62,2,3,1,17,136,25,312,6,1,319,281,600
764,4,32,1,0,1,29,47,5,4,2,8,154,26,313,7,0,320,280,600
765,2,25,1,0,4,33,39,6,0,0,13,150,37,310,9,0,319,281,600
766,1,37,2,0,4,33,48,8,2,6,8,161,24,334,1,0,335,265,600
767,2,22,1,2,0,18,54,7,2,4,7,192,29,340,6,0,346,254,600
768,5,21,3,1,1,25,52,7,0,5,8,162,17,307,5,1,313,287,600
769,2,32,0,1,2,23,61,6,4,1,7,149,31,319,6,1,326,274,600
770,3,30,2,1,1,24,43,3,0,1,19,145,33,305,2,0,307,293,600
771,0,30,1,0,6,25,36,4,1,1,8,187,29,328,3,1,332,268,600
772,1,30,1,1,3,31,40,4,2,4,10,164,26,317,4,3,324,276,600
773,1,35,2,1,1,29,34,5,2,4,15,148,29,306,4,1,311,289,600
774,2,29,1,0,1,23,40,7,2,1,9,174,31,320,3,2,325,275,600
775,1,29,1,3,1,29,36,6,2,3,14,134,38,297,6,2,305,295,600
776,0,23,1,1,0,39,34,4,3,2,11,132,24,274,4,2,280,220,500
777,1,30,3,2,2,15,28,3,5,3,18,144,26,280,3,0,283,217,500
778,2,34,2,0,0,15,33,4,4,1,12,140,38,285,6,1,292,208,500
779,3,29,0,1,3,28,41,2,1,1,19,148,22,298,5,3,306,230,536
780,3,105,1,1,2,42,86,2,1,0,27,41,84,395,2,0,397,203,600
781,1,127,0,2,1,31,105,0,4,0,28,60,75,434,4,0,438,162,600
782,0,109,1,1,1,34,87,6,5,2,39,54,94,433,3,0,436,164,600
783,2,97,2,0,2,45,102,2,2,4,28,48,85,419,1,0,420,180,600
784,2,149,0,1,4,35,86,2,2,1,32,50,61,425,1,1,427,173,600
785,0,122,1,0,7,24,114,5,5,2,38,44,80,442,3,1,446,154,600
786,0,113,0,2,2,51,107,2,2,0,44,44,68,435,2,0,437,163,600
787,1,115,1,1,5,38,110,6,4,1,18,57,63,420,2,0,422,178,600
788,1,110,3,0,1,33,117,3,1,3,29,55,58,414,1,1,416,184,600
789,1,116,2,0,1,33,68,6,7,3,31,73,71,412,5,1,418,182,600
790,0,139,5,0,4,40,92,1,3,0,24,41,64,413,2,1,416,184,600
791,0,124,0,0,3,32,90,3,4,1,38,61,72,428,3,0,431,169,600
792,1,90,1,1,6,35,75,2,4,1,12,57,68,353,1,1,355,145,500
793,0,136,0,0,2,34,83,1,4,2,22,43,80,407,4,0,411,120,531
794,0,83,1,0,2,46,77,2,0,0,13,28,56,308,4,0,312,188,500
795,0,69,0,0,1,36,50,2,3,1,19,17,38,236,2,0,238,162,400
796,0,96,0,0,0,29,73,1,0,0,14,24,70,307,3,1,311,89,400
797,0,44,0,0,2,25,46,2,1,1,17,34,59,231,0,0,231,74,305
798,0,11,0,0,0,7,4,0,0,0,1,4,5,32,0,3,35,39,74
799,0,2,0,0,0,0,8,0,0,1,4,0,9,24,1,0,25,13,38
800,0,75,1,0,1,15,46,0,6,2,19,20,42,227,1,0,228,72,300
801,0,78,0,1,1,19,64,1,3,1,26,32,51,277,2,0,279,104,383
802,3,84,0,1,2,52,117,3,0,2,27,31,47,369,5,2,376,171,547
803,1,64,2,0,3,31,74,1,1,0,20,62,54,313,4,1,318,132,450
804,0,51,0,0,2,31,97,0,0,3,32,51,38,305,6,0,311,139,450
805,1,48,0,0,3,13,55,0,2,0,32,61,49,264,1,3,268,128,396
806,0,8,1,0,2,1,29,0,0,1,5,2,23,72,0,0,72,36,108
807,1,22,1,0,1,10,27,0,2,1,3,9,18,95,1,1,97,69,166
808,1,7,0,0,0,14,23,0,0,1,1,4,3,54,0,0,54,25,79
809,2,17,1,0,1,10,33,4,0,3,18,12,14,115,5,0,120,63,183
811,0,3,0,0,0,1,26,0,0,0,1,5,17,53,0,0,53,50,103
812,2,48,0,0,2,29,88,3,2,0,18,15,29,236,3,1,240,110,350
813,3,96,0,0,3,34,66,2,1,2,19,30,48,304,6,2,312,138,450
814,0,77,0,0,3,41,84,2,6,2,13,46,35,309,8,1,318,132,450
815,1,114,0,0,7,28,74,4,1,4,15,59,33,340,3,1,344,116,460
816,0,68,0,1,0,47,59,1,2,2,31,46,63,320,2,2,324,126,450
817,2,65,0,0,2,34,58,3,1,3,42,52,74,336,2,2,340,110,450
818,2,73,0,0,2,38,55,2,2,4,30,58,45,311,4,2,317,102,419
819,0,56,3,1,2,30,65,3,1,2,32,40,54,289,0,2,291,109,400
820,4,58,0,1,2,21,81,2,2,0,55,45,40,311,4,0,315,121,436
821,1,93,1,1,2,46,126,2,1,4,49,77,37,440,1,1,442,158,600
822,1,66,0,0,0,47,94,1,5,1,20,78,46,359,4,1,364,155,519
823,1,40,0,0,1,24,73,0,0,1,36,29,29,234,4,1,239,127,366
824,0,40,0,0,3,39,109,2,2,0,23,30,50,298,1,1,300,100,400
825,0,62,1,0,1,32,83,2,3,2,25,27,69,307,0,0,307,120,427
826,0,26,0,0,2,6,31,0,0,0,7,6,34,112,0,0,112,45,157
827,1,82,0,0,0,50,93,1,0,1,51,21,39,339,2,3,344,156,500
828,0,60,2,2,2,40,99,4,2,1,50,23,34,319,4,1,324,141,465
841,0,19,0,0,0,10,68,0,1,0,12,4,13,127,0,1,128,74,202
842,1,6,0,0,2,6,55,2,2,2,60,38,40,214,4,0,218,131,349
843,1,27,0,0,1,24,43,2,0,1,16,29,30,174,2,0,176,90,266
844,1,12,0,0,0,8,22,1,0,0,13,13,16,86,2,2,90,45,135
845,0,22,0,0,0,14,54,0,1,0,7,44,25,167,3,1,171,129,300
846,1,30,1,0,1,21,62,2,2,1,17,61,20,219,10,2,231,140,371
847,2,6,0,0,2,6,28,0,1,3,10,4,8,70,2,1,73,35,108
848,0,6,0,0,0,19,19,0,0,0,7,12,7,70,0,0,70,34,104
849,0,13,0,0,0,5,35,0,1,0,29,6,15,104,1,1,106,47,153
850,0,15,0,1,0,10,60,1,1,2,2,12,24,128,0,0,128,88,216
851,0,1,0,0,0,1,5,1,0,0,6,9,1,24,1,0,25,22,47
852,4,132,3,1,3,27,81,1,1,2,31,50,71,407,5,0,412,188,600
853,1,164,5,1,2,18,74,4,7,3,33,35,69,416,8,1,425,175,600
854,2,138,1,0,9,22,55,2,0,3,28,41,90,391,6,1,398,202,600
855,1,115,1,0,7,26,58,4,1,3,38,50,91,395,6,0,401,199,600
856,1,142,0,0,7,21,78,3,5,2,27,52,86,424,4,1,429,171,600
857,0,91,0,1,5,30,64,3,4,1,25,43,47,314,6,0,320,180,500
858,3,101,0,1,3,30,56,0,2,1,22,37,57,313,5,1,319,181,500
859,1,131,0,0,5,21,57,0,1,1,20,47,64,348,2,1,351,149,500
860,0,98,2,0,5,13,47,0,9,4,26,32,53,289,5,1,295,138,433
861,2,119,0,1,1,4,53,3,2,2,35,29,73,324,0,3,327,123,450
862,2,116,2,0,9,51,73,7,4,7,27,40,34,372,1,0,373,177,550
863,2,122,2,1,7,26,41,3,3,3,20,62,62,354,1,0,355,194,549
881,3,87,2,1,6,35,81,3,3,1,21,97,53,393,3,3,399,201,600
882,1,76,1,0,2,39,88,6,4,1,25,108,63,414,3,0,417,183,600
883,1,86,0,1,4,51,79,5,1,3,25,91,59,406,1,0,407,193,600
884,1,96,2,1,4,41,73,7,4,4,29,94,57,413,2,1,416,184,600
885,0,89,1,0,0,47,68,5,9,9,25,87,55,395,2,0,397,203,600
886,1,95,0,0,2,39,73,3,7,1,24,79,72,396,6,0,402,198,600
887,0,97,1,1,2,36,87,5,2,2,14,76,75,398,3,0,401,199,600
888,0,99,1,1,2,37,79,6,5,1,17,91,61,400,2,1,403,197,600
889,2,74,2,1,2,38,122,2,4,2,25,73,58,405,3,0,408,192,600
890,1,104,1,0,4,41,78,2,4,3,20,85,69,412,4,0,416,184,600
901,0,76,0,0,3,38,73,3,5,1,22,122,46,389,2,0,391,209,600
902,2,79,0,0,2,30,87,2,4,4,26,90,61,387,4,1,392,208,600
903,0,88,0,0,5,52,56,4,2,4,14,108,60,393,2,0,395,205,600
904,1,100,0,1,2,43,69,4,3,2,24,78,73,400,0,0,400,200,600
905,0,83,2,3,3,40,77,4,0,2,29,95,74,412,0,0,412,188,600
906,0,91,1,0,2,38,102,4,2,1,24,85,75,425,1,0,426,174,600
907,1,87,0,0,0,40,63,6,5,3,17,100,53,375,6,2,383,217,600
908,2,87,2,1,6,47,81,1,1,3,20,91,59,401,1,1,403,197,600
909,2,79,1,0,2,49,66,7,6,0,12,103,62,389,1,1,391,209,600
910,0,113,3,0,2,40,86,5,9,2,22,90,73,445,2,0,447,180,627
911,4,80,0,1,2,26,81,5,2,4,23,113,62,403,4,0,407,193,600
912,0,62,0,2,2,48,67,7,3,3,26,115,51,386,4,0,390,210,600
913,0,72,1,0,5,35,81,2,1,0,37,124,54,412,2,1,415,185,600
914,2,70,2,1,5,40,88,3,3,2,37,120,51,424,2,2,428,172,600
915,1,79,2,1,2,29,52,3,4,0,27,152,34,386,2,0,388,212,600
916,1,71,6,0,0,30,50,0,3,0,36,100,68,365,1,0,366,185,551
917,4,63,0,3,1,29,57,1,2,1,22,96,51,330,4,2,336,164,500
918,2,53,1,0,2,28,53,7,4,1,29,84,50,314,2,0,316,184,500
919,0,38,0,0,2,31,58,7,5,8,29,112,36,326,0,1,327,173,500
920,0,62,1,5,3,32,52,3,1,1,15,111,49,335,2,0,337,163,500
921,1,0,0,1,0,2,4,0,1,0,0,0,16,25,0,1,26,16,42
922,2,75,3,0,1,28,64,5,1,3,14,40,54,290,4,1,295,155,450
923,1,68,3,1,5,19,69,3,3,1,20,39,47,279,3,2,284,166,450
924,2,61,0,0,3,27,78,5,2,1,10,35,45,269,1,1,271,132,403
925,1,18,0,0,0,20,28,1,1,0,7,26,9,111,2,0,113,71,184
926,0,28,1,0,3,18,58,2,1,0,26,26,35,198,3,2,203,95,298
927,1,23,0,0,1,12,30,1,0,3,12,47,11,141,1,0,142,75,217
928,1,136,2,0,1,33,90,5,2,5,42,56,41,414,4,2,420,180,600
929,2,134,1,0,1,40,87,1,0,1,36,43,52,398,2,1,401,199,600
930,4,132,1,2,2,42,62,6,3,1,33,91,34,413,2,1,416,184,600
931,0,137,1,0,4,36,56,2,4,2,30,50,52,374,1,0,375,125,500
932,1,126,1,0,4,31,44,2,1,1,37,55,41,344,7,3,354,146,500
933,3,123,1,3,1,24,64,2,2,1,40,59,55,378,1,0,379,184,563
934,5,94,0,1,4,45,75,4,2,4,23,86,48,391,1,1,393,207,600
935,0,3,0,0,0,4,16,0,0,0,3,7,4,37,4,0,41,26,67
936,0,18,3,0,0,18,79,4,0,1,21,17,18,179,0,0,179,130,309
937,2,21,0,0,0,42,143,0,1,7,37,73,12,338,2,1,341,159,500
938,1,107,1,2,1,35,87,3,3,3,53,70,37,403,5,1,409,191,600
939,2,102,0,1,0,38,102,4,5,2,27,51,35,369,5,2,376,124,500
940,2,110,1,1,5,48,62,2,1,1,17,58,30,338,3,1,342,158,500
941,1,110,1,1,0,27,69,4,1,2,27,67,39,349,3,0,352,148,500
942,0,122,0,1,0,30,66,3,6,2,27,74,45,376,2,0,378,122,500
943,2,124,1,1,2,39,74,7,1,1,25,41,44,362,2,1,365,151,516
944,1,26,0,1,0,27,40,1,1,0,14,45,27,183,0,1,184,107,291
945,3,68,1,0,3,26,98,2,0,1,15,73,27,317,5,1,323,189,512
948,0,14,0,0,3,2,19,0,0,2,2,17,6,65,2,1,68,31,99
949,1,49,0,0,1,4,35,0,0,0,7,32,16,145,6,0,151,47,198
950,3,36,0,0,0,31,204,2,0,1,24,51,37,389,9,3,401,182,583
951,0,19,0,0,0,5,19,2,1,1,4,10,6,67,2,1,70,76,146
952,3,71,2,0,0,45,67,6,4,1,36,96,39,370,4,0,374,226,600
954,1,79,0,1,1,27,83,4,1,2,23,93,64,379,6,0,385,215,600
956,1,56,2,0,2,25,72,7,4,0,21,66,60,316,2,0,318,182,500
961,2,61,2,1,6,30,64,4,3,3,24,80,31,311,3,0,314,186,500
962,2,45,0,2,7,21,76,1,1,3,11,110,41,320,3,0,323,184,507
963,1,139,0,1,2,29,89,0,3,2,9,90,93,458,3,0,461,139,600
964,0,128,0,0,1,42,82,5,7,3,13,77,78,436,4,1,441,159,600
965,0,143,1,1,2,30,74,3,7,0,12,64,90,427,0,2,429,171,600
966,1,127,1,0,2,33,76,4,7,1,17,62,84,415,5,1,421,179,600
967,0,118,0,0,2,41,76,3,9,2,12,68,91,422,2,0,424,176,600
968,0,125,0,1,5,32,57,6,9,1,20,90,81,427,5,0,432,168,600
202,1,103,3,1,3,32,94,6,7,2,10,42,120,424,2,1,427,173,600
498,1,125,0,2,6,38,92,3,5,3,24,84,59,442,0,0,442,158,600
499,1,119,4,0,4,40,97,0,4,1,20,88,65,443,2,0,445,155,600
502,0,100,0,0,4,40,95,1,2,1,19,91,72,425,1,0,426,174,600
591,0,59,2,0,2,44,48,5,0,6,34,164,29,393,2,0,395,205,600
644,1,133,3,1,1,32,93,5,3,2,16,64,91,445,1,1,447,153,600
810,1,35,0,0,0,42,42,4,2,2,20,13,30,191,6,0,197,92,289
829,1,21,1,0,0,25,56,0,1,1,104,8,7,225,3,0,228,113,341
830,0,34,0,0,1,15,127,8,0,2,20,24,20,251,7,0,258,142,400
831,0,36,0,0,0,14,97,8,1,2,18,16,40,232,6,2,240,116,356
832,0,57,2,2,0,20,77,4,1,5,6,15,15,204,5,1,210,89,299
833,1,66,0,0,0,19,105,3,0,1,21,13,46,275,0,0,275,100,375
834,0,128,3,1,0,41,80,3,5,0,43,44,96,444,6,3,453,138,591
835,3,126,0,1,1,41,85,2,2,1,36,87,56,441,4,2,447,153,600
836,0,103,1,1,2,36,119,5,1,2,17,56,52,395,4,2,401,199,600
837,1,98,2,0,0,49,56,1,0,1,27,84,51,370,1,0,371,229,600
838,0,94,1,0,1,22,74,1,3,2,30,65,38,331,1,0,332,168,500
839,1,114,1,1,2,43,72,5,5,2,19,75,56,396,4,0,400,189,589
840,1,44,0,1,0,21,32,3,2,2,4,23,22,155,0,0,155,65,220
864,0,86,5,0,3,26,63,5,2,3,38,66,38,335,6,2,343,257,600
865,4,106,0,0,5,20,82,3,7,4,36,51,69,387,2,0,389,218,607
866,1,2,1,0,1,0,10,0,0,2,1,0,10,28,0,0,28,19,47
867,0,20,0,1,0,5,25,1,0,0,9,15,9,85,0,2,87,40,127
868,3,94,2,0,5,16,72,3,0,0,47,40,70,352,3,1,356,244,600
869,0,93,0,0,3,38,68,6,0,7,35,51,73,374,0,0,374,226,600
870,0,90,1,1,2,13,60,2,4,6,35,39,49,302,6,0,308,192,500
871,0,93,1,0,1,19,76,2,4,3,16,46,53,314,4,3,321,181,502
872,0,1,0,0,0,0,1,0,0,0,1,6,5,14,1,0,15,14,29
873,0,18,0,0,1,2,27,0,0,1,13,4,7,73,1,1,75,55,130
874,0,18,0,1,1,6,55,2,1,1,8,22,17,132,3,0,135,70,205
875,0,35,1,1,1,9,48,0,0,0,20,19,44,178,0,0,178,90,268
876,1,1,0,0,0,2,3,1,0,0,0,27,7,42,0,0,42,7,49
877,1,66,1,0,4,16,45,3,1,1,24,43,77,282,5,0,287,169,456
878,0,48,3,1,5,18,64,3,1,2,29,24,77,275,11,0,286,170,456
879,2,53,3,0,1,15,62,4,1,4,17,80,110,352,2,1,355,175,530
880,0,95,0,1,0,37,78,2,0,1,26,94,66,400,3,0,403,197,600
891,0,108,2,0,3,36,101,4,3,3,19,62,84,425,0,0,425,175,600
892,1,109,2,2,3,37,77,3,3,2,25,72,61,397,3,0,400,200,600
893,2,98,3,1,6,38,73,7,2,2,23,68,69,392,2,0,394,206,600
894,1,83,1,1,4,43,73,1,3,2,29,115,53,409,4,0,413,187,600
895,1,79,1,0,4,42,81,3,2,2,19,108,75,417,1,0,418,182,600
896,1,95,3,1,3,41,83,8,0,4,13,81,63,396,4,0,400,200,600
897,0,76,5,2,9,30,63,2,1,1,19,110,69,387,6,0,393,207,600
898,1,108,0,1,6,28,73,7,5,1,30,79,76,415,5,0,420,180,600
899,6,112,0,1,6,49,93,4,1,8,24,73,60,437,3,0,440,160,600
900,2,103,1,1,5,36,77,1,4,2,21,88,69,410,0,0,410,190,600
946,2,89,0,2,1,36,89,6,0,1,23,24,71,344,3,0,347,234,581
947,0,13,0,2,0,8,23,1,1,1,2,6,2,59,2,1,62,22,84
953,1,66,1,0,2,27,121,2,1,1,26,101,45,394,6,2,402,198,600
955,2,74,1,0,4,30,80,6,1,1,24,92,38,353,7,0,360,240,600
957,0,70,0,0,3,32,76,1,1,2,23,77,41,326,3,0,329,171,500
958,2,81,0,0,0,33,96,4,3,3,37,90,38,387,4,1,392,183,575
959,1,75,1,0,1,33,89,4,4,3,23,119,58,411,2,1,414,186,600
960,1,58,2,0,1,34,67,13,5,2,32,138,37,390,5,0,395,205,600
969,1,129,1,2,3,39,63,1,2,2,18,99,68,428,1,0,429,171,600
970,0,132,2,1,4,46,83,2,12,0,15,59,89,445,4,0,449,151,600
971,1,141,1,1,6,31,51,3,2,6,18,88,66,415,3,0,418,182,600
972,3,101,0,0,3,22,71,2,0,2,15,92,74,385,1,2,388,212,600
973,0,117,2,0,2,31,72,1,5,0,18,81,92,421,2,0,423,177,600
974,1,121,2,0,1,21,69,1,0,2,24,76,96,414,4,0,418,182,600
975,0,84,2,0,2,34,52,5,2,3,18,48,56,306,4,0,310,190,500
976,1,124,1,1,5,30,64,4,2,2,17,70,88,409,0,1,410,163,573
977,1,16,0,0,0,26,25,3,0,2,9,33,34,149,5,2,156,120,276
978,1,78,0,0,0,19,55,3,0,1,8,33,48,246,2,2,250,70,320
979,2,134,6,0,2,35,67,7,3,1,12,56,114,439,4,0,443,157,600
980,1,125,1,0,2,48,67,6,6,1,18,64,105,444,1,0,445,155,600
981,1,113,0,1,3,30,78,6,5,4,13,52,115,421,3,1,425,176,601
982,2,126,4,1,4,39,62,2,0,3,23,81,79,426,8,0,434,166,600
983,3,132,2,0,4,51,83,3,3,1,24,77,60,443,2,0,445,173,618
984,0,28,2,0,0,16,64,0,1,2,9,23,12,157,3,2,162,90,252
985,0,56,0,1,0,40,56,2,7,0,15,90,60,327,1,2,330,170,500
986,1,92,0,0,0,30,50,5,2,1,19,93,51,344,2,0,346,154,500
987,2,77,1,0,0,18,50,4,2,2,16,87,58,317,0,1,318,182,500
988,0,70,0,0,2,21,34,3,3,0,13,77,29,252,2,0,254,163,417
989,0,67,1,1,4,24,54,3,2,0,16,54,39,265,2,0,267,133,400
990,0,47,2,0,3,35,62,2,2,1,13,46,35,248,9,3,260,140,400
991,0,63,1,0,4,32,48,2,3,2,18,78,48,299,1,2,302,155,457
992,0,59,1,0,1,35,55,2,3,3,7,82,68,316,1,1,318,182,500
993,1,59,1,0,0,25,42,3,1,2,5,87,72,298,5,2,305,195,500
994,0,64,0,0,0,22,31,3,3,3,11,64,80,281,3,0,284,116,400
995,1,81,2,0,1,42,56,6,4,0,22,38,140,393,1,3,397,149,546
996,2,36,0,0,1,22,33,1,1,3,6,75,25,205,2,0,207,93,300
997,1,32,1,1,1,27,33,4,1,1,18,111,28,259,2,1,262,103,365
998,0,39,1,0,1,15,52,1,1,2,13,33,42,200,1,0,201,123,324
999,2,27,1,0,2,28,27,0,0,0,7,20,27,141,2,0,143,85,228
1000,3,10,1,0,0,10,32,0,0,1,4,10,19,90,2,1,93,38,131
1001,0,19,0,0,0,9,16,0,0,0,4,11,8,67,1,0,68,26,94
1002,0,44,0,0,2,13,39,2,1,1,14,34,25,175,0,1,176,82,258
1003,0,17,0,0,0,21,41,3,1,1,2,14,13,113,2,1,116,89,205
1004,0,45,1,1,0,22,59,2,2,0,14,42,58,246,1,1,248,69,317
1005,0,1,0,0,0,4,4,10,0,0,4,2,3,28,0,0,28,11,39
1006,2,70,0,0,7,23,63,2,1,0,24,36,34,262,5,2,269,131,400
1007,1,47,1,0,5,36,84,5,6,1,30,55,27,298,5,2,305,180,485
1008,0,42,0,0,2,23,39,1,1,4,24,100,69,305,6,4,315,185,500
1009,2,41,0,0,0,22,44,3,3,5,19,94,55,288,6,4,298,157,455
1010,2,134,1,1,2,34,84,5,6,4,13,62,87,435,3,0,438,162,600
1011,0,116,2,1,3,40,83,5,2,1,18,67,75,413,2,1,416,184,600
1012,0,138,2,0,2,38,74,4,7,3,13,79,72,432,3,1,436,164,600
1013,1,108,3,1,7,29,83,7,1,2,22,77,80,421,4,2,427,173,600
1014,0,116,3,0,5,38,81,3,4,3,10,75,84,422,3,0,425,175,600
1015,3,106,1,0,2,49,61,4,3,1,16,92,78,416,1,1,418,182,600
1016,1,152,1,2,6,40,65,1,5,3,8,68,62,414,2,0,416,184,600
1017,1,114,0,0,5,34,80,2,7,2,14,99,81,439,3,0,442,158,600
1018,1,115,1,0,3,44,89,2,6,1,12,58,92,424,3,0,427,173,600
1019,3,105,5,0,6,39,57,3,0,1,14,87,67,387,1,1,389,211,600
1020,3,102,0,0,3,33,80,5,5,2,17,98,83,431,4,0,435,165,600
1021,0,124,0,0,3,39,66,7,3,0,16,70,78,406,1,0,407,193,600
1022,0,123,1,2,2,50,78,4,7,4,13,72,79,435,1,1,437,163,600
1023,1,119,1,2,5,36,73,6,3,1,15,75,95,432,5,0,437,163,600
1024,1,136,3,2,5,40,72,1,4,3,19,73,69,428,1,0,429,171,600
1025,0,128,2,1,5,38,80,3,1,1,12,63,89,423,4,1,428,172,600
1026,2,110,0,0,1,38,82,2,5,1,16,85,65,407,1,0,408,192,600
1027,4,136,1,0,6,42,55,4,4,5,11,77,86,431,2,0,433,167,600
1028,3,112,1,2,2,46,69,4,5,1,17,79,85,426,2,1,429,171,600
1029,2,135,2,0,5,40,78,6,1,1,19,76,77,442,1,1,444,156,600
1030,4,129,3,1,7,33,65,1,0,2,10,80,76,411,1,2,414,186,600
1031,0,115,2,2,2,44,77,3,6,4,7,82,71,415,3,0,418,182,600
1032,1,129,0,0,3,46,83,4,5,1,17,81,68,438,2,1,441,159,600
1033,1,106,2,0,0,46,61,8,1,3,11,71,86,396,3,1,400,200,600
1034,1,95,2,1,3,34,76,5,4,7,14,87,77,406,2,0,408,192,600
1035,0,131,1,0,4,50,84,3,4,3,6,87,75,448,2,0,450,150,600
1036,0,127,3,3,2,29,81,4,0,1,15,82,86,433,1,0,434,166,600
1037,1,111,4,1,10,46,83,2,4,4,15,68,70,419,1,0,420,180,600
1038,0,124,4,3,5,36,59,4,1,2,20,75,86,419,3,0,422,178,600
1039,0,129,1,1,3,30,89,1,7,0,11,94,59,425,1,1,427,173,600
1040,2,97,3,0,1,31,59,0,3,0,10,67,64,337,5,1,343,157,500
1041,0,96,0,0,2,27,57,6,1,3,20,68,75,355,1,0,356,144,500
1042,0,92,1,0,5,36,63,0,2,4,13,83,55,354,4,0,358,142,500
1043,1,85,1,0,5,25,76,3,1,1,5,74,66,343,3,0,346,154,500
1044,3,97,1,1,1,37,78,5,5,1,12,62,78,381,1,2,384,144,528
1045,0,9,0,0,0,7,22,0,0,2,3,6,21,70,0,0,70,61,131
1046,4,100,0,1,5,38,85,5,3,3,35,68,78,425,6,2,433,167,600
1047,0,72,3,1,1,47,51,3,4,4,17,78,73,354,1,1,356,144,500
1048,1,91,0,1,1,42,48,3,5,3,21,54,66,336,5,0,341,159,500
1049,1,75,1,1,2,36,60,7,2,1,16,62,78,342,3,0,345,104,449
1050,1,114,2,0,5,42,71,6,6,2,19,58,103,429,7,0,436,164,600
1051,2,150,2,0,1,34,62,1,1,1,23,71,95,443,2,0,445,155,600
1052,1,122,1,1,2,35,76,6,3,5,20,66,97,435,3,1,439,161,600
1053,0,136,0,1,3,30,75,5,4,4,15,64,85,422,7,0,429,171,600
1054,1,128,1,1,5,50,65,5,5,3,9,70,91,434,2,0,436,164,600
1055,2,125,1,1,5,43,53,8,4,3,9,81,91,426,2,1,429,171,600
1056,0,116,3,0,7,45,67,1,3,2,13,76,106,439,1,1,441,158,599
1057,1,119,2,0,4,34,79,5,7,2,15,74,96,438,4,0,442,158,600
1058,1,120,1,1,8,29,59,9,3,5,28,92,84,440,4,0,444,156,600
1059,1,111,2,2,6,35,75,7,6,4,17,75,82,423,1,1,425,175,600
1060,2,123,2,1,3,37,67,0,2,1,16,71,93,418,3,0,421,179,600
1061,2,117,4,2,3,43,78,4,8,3,14,66,93,437,0,1,438,162,600
1062,1,118,1,1,4,48,71,7,2,1,16,60,96,426,1,0,427,173,600
1063,0,124,3,1,5,40,68,6,1,1,12,67,95,423,2,1,426,174,600
1064,1,109,0,1,4,47,69,8,3,2,17,86,91,438,4,1,443,157,600
1065,1,128,3,1,6,36,76,4,10,4,10,90,89,458,0,0,458,142,600
1066,0,124,1,0,3,43,71,5,2,4,11,89,81,434,3,1,438,162,600
1067,1,128,0,1,10,35,79,12,2,3,14,73,75,433,4,1,438,162,600
1068,0,104,1,0,7,36,85,5,8,1,16,77,76,416,0,0,416,150,566
1069,0,122,3,0,0,30,45,3,6,2,11,54,78,354,0,0,354,146,500
1070,0,4,0,0,0,0,4,0,0,0,0,0,0,8,0,0,8,9,17
1071,0,125,1,1,3,34,85,4,11,2,18,103,68,455,0,1,456,144,600
1072,1,121,2,1,4,35,71,3,5,2,14,90,86,435,1,1,437,163,600
1073,3,133,2,2,3,24,77,5,3,3,12,93,64,424,5,0,429,171,600
1074,0,110,1,2,2,35,67,3,2,2,15,90,76,405,0,1,406,194,600
1075,1,146,0,0,5,37,62,2,3,0,12,105,70,443,0,0,443,157,600
1076,0,126,0,0,5,34,80,4,5,1,29,97,71,452,1,0,453,147,600
1077,2,127,1,1,5,31,68,7,3,1,15,94,103,458,0,0,458,142,600
1078,1,161,2,0,6,32,59,6,7,3,9,91,67,444,3,0,447,153,600
1079,0,142,0,0,4,21,71,3,4,0,13,110,69,437,1,1,439,161,600
1080,1,115,3,0,1,36,73,2,9,0,10,100,90,440,3,1,444,156,600
1081,0,110,1,0,4,27,70,4,4,4,17,111,78,430,1,0,431,169,600
1082,1,129,2,0,2,30,69,2,3,1,12,110,74,435,0,1,436,164,600
1083,1,131,2,2,3,30,61,2,9,2,17,103,60,423,3,0,426,174,600
1084,0,153,3,0,2,27,50,4,8,4,14,86,76,427,4,2,433,167,600
1085,1,139,0,0,1,39,65,6,4,1,14,90,75,435,0,0,435,165,600
1086,1,122,1,0,5,33,55,4,3,1,15,99,71,410,0,0,410,190,600
1087,0,131,6,0,1,24,62,3,4,0,25,106,63,425,4,0,429,171,600
1088,2,164,2,0,2,24,56,2,3,3,10,89,71,428,2,0,430,170,600
1089,2,125,1,0,3,36,82,3,6,1,7,93,78,437,0,0,437,163,600
1090,0,122,3,0,7,37,69,5,7,1,13,76,80,420,2,3,425,175,600
1091,2,127,1,1,2,20,67,6,4,1,13,95,75,414,5,0,419,181,600
1092,0,128,4,0,3,24,68,2,4,2,10,76,52,373,4,0,377,163,540
1093,1,96,2,0,3,41,67,4,7,3,28,121,58,431,2,1,434,166,600
1094,1,132,1,1,2,28,60,6,3,3,19,77,63,396,2,0,398,202,600
1095,1,120,3,1,1,34,54,3,2,3,13,112,49,396,1,0,397,203,600
1096,0,120,3,3,2,36,44,5,3,4,17,129,59,425,2,0,427,173,600
1097,4,100,2,0,2,45,66,0,5,1,13,111,47,396,3,0,399,201,600
1098,0,92,2,0,3,38,45,4,1,1,17,82,52,337,0,0,337,163,500
1099,1,108,0,1,3,25,53,2,2,6,11,84,44,340,2,0,342,158,500
1100,2,76,0,2,3,35,58,0,4,5,7,103,57,352,3,1,356,144,500
1101,0,102,1,2,4,32,46,2,5,3,11,82,65,355,2,0,357,143,500
1102,0,121,1,1,6,31,49,5,2,1,22,114,72,425,1,0,426,158,584
1103,3,110,0,1,1,42,62,6,3,2,21,136,47,434,2,0,436,164,600
1104,0,78,3,0,2,50,74,5,8,4,15,136,61,436,2,1,439,161,600
1105,1,101,3,0,4,41,79,5,2,4,15,133,52,440,4,0,444,156,600
1106,1,95,2,1,3,36,57,5,4,5,16,124,62,411,2,1,414,186,600
1107,1,115,2,0,2,37,59,6,6,4,22,120,64,438,4,0,442,158,600
1108,2,112,6,0,0,46,58,4,4,2,16,148,41,439,2,0,441,159,600
1109,1,94,3,0,2,40,47,3,4,2,25,153,58,432,2,2,436,164,600
1110,1,93,2,3,6,32,49,4,6,2,22,138,59,417,8,2,427,173,600
1111,0,71,3,0,1,44,53,0,7,3,16,117,46,361,2,0,363,137,500
1112,0,61,3,2,5,42,50,4,2,3,16,113,48,349,0,0,349,151,500
1113,1,119,0,3,4,42,58,1,2,2,11,131,45,419,2,0,421,157,578
1114,0,81,3,0,3,25,45,5,3,3,26,155,44,393,7,1,401,199,600
1115,2,70,1,0,8,36,55,5,4,1,16,157,43,398,3,0,401,199,600
1116,3,86,2,1,1,38,45,4,2,3,25,134,55,399,4,0,403,197,600
1117,0,79,0,1,7,44,42,3,1,3,31,155,53,419,4,0,423,177,600
1118,2,60,6,2,1,45,64,4,2,3,25,157,48,419,5,0,424,176,600
1119,1,84,1,0,2,38,80,2,2,2,17,144,56,429,1,0,430,170,600
1120,1,72,2,1,2,49,52,5,2,0,29,136,47,398,4,1,403,197,600
1121,1,56,3,1,5,40,47,2,5,2,20,167,51,400,1,0,401,199,600
1122,2,84,2,1,6,35,51,10,4,7,32,108,52,394,5,0,399,201,600
1123,1,63,0,2,2,37,61,5,2,4,24,149,37,387,0,1,388,212,600
1124,0,74,3,0,2,50,41,6,3,1,21,149,42,392,0,0,392,208,600
1125,0,81,3,0,8,33,63,4,5,2,24,133,45,401,3,0,404,196,600
1126,2,92,2,1,8,42,53,2,0,2,19,127,51,401,2,1,404,196,600
1127,0,65,2,0,1,35,65,5,3,4,25,146,43,394,3,0,397,203,600
1128,1,91,3,2,6,42,59,4,2,0,23,129,41,403,1,3,407,192,599
1129,1,73,2,1,3,32,51,3,1,2,21,155,58,403,2,0,405,195,600
1130,3,56,2,2,5,43,53,3,5,3,17,151,56,399,7,2,408,192,600
1131,1,83,0,1,3,35,49,6,3,3,29,165,43,421,2,0,423,177,600
1132,1,84,1,0,5,24,50,5,1,3,12,123,36,345,3,1,349,160,509
1133,2,46,0,0,0,15,69,12,4,9,26,41,35,259,1,2,262,151,413
1134,1,59,0,0,2,12,74,14,2,5,19,61,42,291,1,0,292,108,400
1135,0,61,1,1,2,30,61,6,9,3,14,129,55,372,8,0,380,220,600
1136,1,66,3,1,2,29,51,5,1,6,13,134,47,359,1,0,360,240,600
1138,0,68,1,1,2,45,74,7,3,3,22,130,40,396,7,0,403,221,624
1139,0,86,2,1,1,32,60,5,3,4,24,111,49,378,3,0,381,219,600
1140,0,79,3,1,3,32,58,6,3,4,21,121,51,382,7,2,391,209,600
1141,1,72,0,0,0,49,56,3,5,3,16,127,63,395,6,0,401,199,600
1142,3,97,7,3,1,29,52,2,5,0,26,111,56,392,2,1,395,205,600
1143,2,88,2,1,2,33,43,4,3,3,18,123,58,380,1,2,383,217,600
1144,1,81,2,1,6,33,46,4,6,2,17,121,76,396,4,1,401,199,600
1145,1,81,3,0,5,33,55,1,3,6,22,126,51,387,0,0,387,213,600
1146,0,79,1,0,2,43,57,4,2,3,24,108,57,380,0,0,380,220,600
1147,0,87,0,0,0,29,65,5,5,1,11,123,56,382,5,1,388,212,600
1148,1,84,1,3,4,34,42,1,6,4,20,114,54,368,4,0,372,228,600
1149,2,77,2,0,2,35,70,3,4,4,25,119,45,388,0,0,388,212,600
1150,1,108,2,1,3,34,59,8,6,4,20,99,41,386,1,1,388,212,600
1151,1,88,3,1,3,35,56,2,3,4,23,117,51,387,3,0,390,210,600
1152,1,91,3,0,0,29,64,3,7,2,16,134,42,392,1,1,394,206,600
1153,2,81,1,1,4,49,45,4,3,1,21,113,51,376,5,0,381,219,600
1154,1,88,2,1,6,33,48,4,4,3,28,129,55,402,2,0,404,196,600
1155,4,75,3,0,5,17,45,4,2,1,16,114,44,330,2,0,332,228,560
1156,2,57,4,0,0,26,44,2,3,0,14,142,22,316,2,0,318,282,600
1157,2,41,0,0,4,24,35,5,3,3,8,184,31,340,1,0,341,259,600
1158,2,52,1,0,4,24,50,3,1,2,19,156,35,349,5,1,355,245,600
1159,0,41,0,1,1,19,35,5,0,3,8,170,28,311,5,0,316,284,600
1160,0,35,0,0,2,31,24,10,3,2,11,162,30,310,2,0,312,288,600
1161,1,43,6,0,2,24,30,4,1,1,14,154,28,308,4,0,312,287,599
1162,1,23,1,0,2,17,35,3,0,3,12,156,25,278,7,3,288,212,500
1163,0,44,0,0,0,23,34,5,3,1,14,132,27,283,6,1,290,210,500
1164,2,32,2,0,3,14,22,8,1,3,11,150,22,270,1,2,273,227,500
1165,0,54,0,2,0,16,36,4,3,3,13,126,28,285,3,0,288,270,558
1166,0,115,3,2,6,31,96,0,2,0,17,46,135,453,3,0,456,144,600
1167,3,113,0,1,0,33,95,6,4,2,11,58,129,455,0,0,455,145,600
1168,1,81,1,0,2,44,118,3,4,1,9,47,154,465,1,1,467,133,600
1169,0,95,2,1,0,41,114,0,3,1,12,45,129,443,1,0,444,156,600
1170,2,104,1,1,1,30,105,4,3,2,18,51,107,429,3,1,433,167,600
1171,0,90,1,1,2,30,113,2,1,1,11,54,128,434,0,1,435,165,600
1172,1,88,0,2,0,33,76,2,3,3,13,79,132,432,6,0,438,162,600
1173,0,105,2,2,4,36,112,2,5,1,15,70,120,474,2,0,476,124,600
1174,1,108,1,1,4,27,93,3,5,0,8,53,139,443,1,0,444,156,600
1175,1,121,0,1,2,40,99,5,7,2,8,48,121,455,0,1,456,144,600
1176,2,101,1,3,2,34,93,0,7,0,11,62,118,434,2,0,436,164,600
1177,0,95,1,0,1,27,107,3,3,4,13,42,105,401,2,4,407,137,544
1178,0,111,2,1,1,38,97,7,1,1,18,48,113,438,3,2,443,157,600
1179,2,122,4,1,6,41,94,6,2,3,19,46,112,458,3,0,461,139,600
1180,0,101,0,0,7,35,71,6,4,4,14,60,85,387,2,2,391,128,519
1181,0,78,1,1,3,39,114,2,2,0,30,55,67,392,4,1,397,203,600
1182,0,64,1,1,0,33,78,5,2,1,15,45,62,307,3,0,310,190,500
1183,2,63,0,0,0,28,112,4,3,0,14,51,52,329,4,0,333,167,500
1184,1,58,0,1,2,32,103,2,2,0,14,69,52,336,3,0,339,161,500
1185,0,74,1,0,0,34,111,2,1,1,18,29,49,320,2,0,322,145,467
1186,0,24,0,0,0,16,75,3,0,0,12,17,25,172,5,1,178,139,317
1187,2,103,2,0,1,31,98,6,5,3,24,60,124,459,3,0,462,138,600
1188,0,89,0,2,2,25,100,4,2,2,14,63,119,422,2,0,424,176,600
1189,2,98,0,1,0,33,78,4,1,0,10,52,169,448,3,0,451,149,600
1190,0,84,0,3,2,25,103,2,1,2,10,64,146,442,4,0,446,154,600
1191,0,91,1,0,0,27,101,4,0,1,18,53,141,437,3,1,441,159,600
1192,0,89,1,0,2,29,83,7,8,1,16,49,137,422,2,0,424,176,600
1193,1,75,1,2,1,35,86,6,2,1,19,51,149,429,4,2,435,165,600
1194,0,86,2,1,1,25,102,3,4,1,11,37,132,405,2,1,408,192,600
1195,0,117,1,2,1,36,91,6,6,0,12,46,118,436,1,1,438,162,600
1196,1,77,0,1,0,18,77,6,2,1,11,36,128,358,3,0,361,139,500
1197,0,78,0,0,0,27,102,4,4,1,14,31,114,375,5,1,381,119,500
1198,0,84,0,1,0,32,75,5,3,1,13,42,115,371,3,0,374,126,500
1199,1,66,1,0,1,32,88,7,3,0,10,38,111,358,0,0,358,142,500
1200,0,89,0,1,4,32,68,4,4,2,11,57,90,362,2,0,364,136,500
1201,0,91,0,0,1,41,99,1,1,4,15,39,129,421,2,0,423,157,580
1202,0,107,1,1,0,48,72,5,4,2,22,74,79,415,2,1,418,182,600
1203,0,73,0,1,2,33,75,8,5,5,7,64,95,368,2,0,370,153,523
1204,1,73,0,2,0,25,50,4,2,4,6,71,45,283,4,0,287,113,400
1206,0,74,1,3,2,34,51,2,2,1,16,103,77,366,4,0,370,117,487
1207,2,105,0,0,2,34,77,4,5,3,18,77,109,436,1,0,437,163,600
1208,0,94,1,0,3,38,100,13,4,1,17,57,114,442,0,1,443,157,600
1209,0,87,2,2,1,32,80,7,2,0,26,61,102,402,6,0,408,192,600
1210,0,98,0,1,1,18,92,5,4,1,18,57,127,422,4,0,426,174,600
1211,0,91,1,1,0,37,94,16,9,2,14,48,105,418,2,1,421,179,600
1212,1,88,0,0,0,32,127,5,0,1,22,56,103,435,4,1,440,160,600
1213,2,84,1,0,0,31,72,4,6,1,11,45,104,361,0,0,361,139,500
1214,0,65,0,2,5,27,76,4,2,2,21,58,78,340,0,1,341,159,500
1215,0,85,0,1,2,20,77,3,3,0,25,51,96,363,1,0,364,146,510
1216,2,45,0,0,1,24,54,2,0,2,24,45,30,229,9,1,239,114,353
1217,0,33,5,1,1,19,29,3,1,1,16,45,46,200,4,0,204,96,300
1218,0,111,0,1,2,40,96,3,3,2,12,62,93,425,5,0,430,170,600
1219,0,97,1,3,3,45,90,3,4,0,23,67,77,413,4,0,417,183,600
1220,3,109,0,0,4,39,84,3,9,1,9,73,92,426,2,0,428,172,600
1221,0,105,3,1,3,52,67,4,6,1,8,53,114,417,2,1,420,180,600
1222,3,109,1,0,2,39,74,7,7,3,15,63,106,429,3,1,433,167,600
1223,0,104,3,3,1,42,66,5,5,3,12,98,102,444,5,0,449,151,600
1224,0,102,3,2,0,27,81,1,2,1,11,52,82,364,1,0,365,135,500
1225,1,73,2,0,3,27,83,2,7,2,13,51,87,351,1,0,352,148,500
1226,1,99,0,2,0,32,90,1,4,7,9,76,76,397,2,2,401,141,542
1227,1,116,1,1,0,29,78,3,1,0,16,66,77,389,3,0,392,140,532
1228,2,96,2,0,1,20,65,6,4,1,15,58,78,348,1,0,349,151,500
1229,0,80,0,1,2,27,64,3,2,4,12,70,97,362,1,1,364,136,500
1230,2,75,3,0,2,45,67,2,10,3,21,134,53,417,2,0,419,181,600
1231,2,79,1,0,3,56,55,4,9,0,32,119,45,405,6,0,411,189,600
1232,1,78,1,1,2,65,30,3,5,2,15,118,45,366,6,1,373,227,600
1233,2,87,4,2,3,39,62,7,6,2,29,122,47,412,4,0,416,184,600
1234,4,87,3,2,2,45,43,5,9,6,25,94,67,392,2,3,397,203,600
1235,2,75,0,5,2,49,66,10,2,1,13,125,46,396,2,0,398,202,600
1236,0,88,5,0,2,40,61,2,6,2,21,99,58,384,2,1,387,213,600
1237,3,85,2,0,1,35,58,6,8,6,23,127,39,393,4,0,397,203,600
1238,2,75,0,2,1,53,59,2,6,4,20,107,49,380,4,2,386,214,600
1239,2,110,2,2,2,43,56,6,6,2,17,105,41,394,7,0,401,199,600
1240,3,65,1,2,1,54,65,5,5,5,31,111,56,404,4,0,408,192,600
1241,3,91,1,0,1,49,41,5,14,2,30,115,42,394,4,0,398,202,600
1242,3,99,1,1,0,50,56,4,6,8,18,119,51,416,3,0,419,181,600
1243,2,87,2,1,1,36,55,3,13,6,27,117,55,405,1,0,406,194,600
1244,3,82,0,2,2,49,61,3,6,1,22,107,63,401,3,0,404,196,600
1245,2,109,0,0,4,42,59,4,7,0,17,105,54,403,2,0,405,195,600
1246,4,86,3,0,4,39,51,4,5,1,30,115,36,378,5,0,383,164,547
1247,2,87,0,1,3,46,46,0,10,3,17,118,61,394,3,0,397,203,600
1248,0,103,1,3,2,51,60,2,6,4,37,102,49,420,3,0,423,177,600
1249,1,86,2,1,1,42,52,3,14,10,27,108,63,410,1,2,413,187,600
1250,2,92,2,2,2,44,55,3,5,1,25,100,68,401,4,0,405,195,600
1251,0,96,1,1,3,43,41,4,13,2,17,117,56,394,5,0,399,201,600
1252,1,90,3,4,1,48,45,4,7,5,25,129,60,422,5,0,427,173,600
1261,0,75,2,0,4,34,45,4,9,1,34,97,40,345,0,2,347,153,500
1262,0,80,4,1,2,44,50,7,6,2,18,94,32,340,2,2,344,162,506
1263,2,56,2,2,6,25,48,5,2,1,15,63,21,248,3,0,251,141,392
1264,0,71,4,2,2,34,40,5,5,2,31,142,30,368,4,2,374,226,600
1265,1,51,1,1,3,55,51,1,4,1,29,141,37,376,4,0,380,220,600
1266,2,63,2,1,2,47,51,5,3,5,29,146,38,394,1,0,395,205,600
1267,3,65,0,0,2,55,42,7,7,1,18,150,39,389,4,2,395,205,600
1268,0,60,1,2,7,42,40,6,4,2,12,162,36,374,6,1,381,219,600
1269,1,80,0,2,2,47,46,9,4,4,18,137,44,394,3,1,398,202,600
1270,1,58,1,0,2,46,49,3,10,0,24,142,29,365,2,1,368,232,600
1271,0,65,3,0,1,44,46,2,7,6,15,122,48,359,1,2,362,238,600
1272,0,49,3,2,3,42,39,4,3,2,34,154,48,383,5,0,388,212,600
1281,3,40,0,0,3,22,53,7,2,0,12,141,39,322,2,2,326,174,500
1301,2,50,1,0,1,41,57,10,8,1,19,157,25,372,5,1,378,222,600
1302,0,43,5,2,3,21,52,6,4,5,20,146,38,345,3,0,348,252,600
1303,2,41,2,2,3,33,40,7,4,3,23,146,47,353,5,1,359,241,600
1304,3,61,4,0,1,34,38,8,1,2,18,156,26,352,5,2,359,241,600
1305,1,47,1,2,6,40,34,11,2,4,17,161,32,358,5,2,365,235,600
1306,2,63,1,0,2,39,26,3,10,4,28,138,41,357,6,0,363,237,600
1307,2,50,1,0,0,38,28,3,5,7,14,135,32,315,1,1,317,183,500
1308,1,34,0,0,2,28,44,6,0,1,13,146,50,325,0,0,325,175,500
1309,1,42,1,1,1,24,47,9,2,1,18,131,34,312,3,0,315,185,500
1310,0,44,1,3,2,33,36,12,1,4,19,119,32,306,8,1,315,216,531
1137,4,74,1,0,2,35,52,3,3,3,17,117,56,367,7,0,374,226,600
1205,0,70,1,2,0,22,37,7,0,0,21,60,60,280,3,0,283,117,400
1253,0,103,1,0,3,48,32,3,10,1,40,97,52,390,2,0,392,208,600
1254,5,89,4,0,0,50,40,3,14,3,27,107,70,412,4,0,416,184,600
1255,1,79,4,2,5,43,41,6,10,3,24,141,42,401,5,1,407,193,600
1256,2,77,2,1,2,47,49,7,7,0,25,127,44,390,4,2,396,204,600
1257,1,92,2,3,3,36,47,3,11,1,23,111,63,396,3,0,399,201,600
1258,2,64,1,0,0,31,55,4,2,1,21,109,44,334,3,0,337,163,500
1259,4,63,1,1,1,35,45,2,9,3,31,98,42,335,3,0,338,167,505
1260,1,65,5,2,1,29,41,3,6,4,20,83,39,299,3,0,302,198,500
1273,1,53,2,1,1,49,41,4,9,3,21,165,45,395,3,1,399,201,600
1274,2,65,0,0,5,31,46,3,4,2,16,131,25,330,6,0,336,164,500
1275,2,42,2,0,0,42,37,7,6,4,13,148,26,329,5,0,334,166,500
1276,1,45,0,1,1,43,46,1,3,1,22,122,29,315,1,0,316,184,500
1277,3,62,4,0,4,32,37,2,8,0,22,103,43,320,4,1,325,181,506
1278,2,71,1,0,3,40,39,6,5,1,22,130,46,366,5,0,371,229,600
1279,4,73,0,4,1,38,39,8,3,2,19,141,44,376,4,0,380,220,600
1280,5,56,1,3,2,29,38,8,5,4,26,137,49,363,6,0,369,231,600
1282,1,55,0,1,3,44,32,6,6,7,22,114,31,322,4,1,327,173,500
1283,1,42,1,1,2,34,20,9,3,1,18,138,30,300,4,0,304,196,500
1284,4,45,1,1,3,44,31,4,5,4,33,107,32,314,11,0,325,175,500
1285,2,43,0,0,8,36,46,3,6,2,20,116,30,312,3,0,315,189,504
1286,1,76,0,1,3,51,59,4,7,3,15,135,48,403,3,0,406,194,600
1287,1,74,3,1,7,39,58,7,4,1,21,128,41,385,3,0,388,212,600
1288,3,80,1,1,2,54,41,6,3,3,22,116,64,396,5,2,403,197,600
1289,0,78,1,1,0,42,56,5,6,2,18,129,39,377,8,0,385,215,600
1290,0,78,0,0,4,47,51,7,10,1,24,119,44,385,3,1,389,211,600
1291,0,79,1,0,3,55,59,3,7,3,18,127,51,406,4,0,410,190,600
1292,3,60,0,0,2,38,52,9,6,2,24,131,54,381,3,0,384,216,600
1293,3,83,1,0,3,49,33,5,4,1,24,108,39,353,4,1,358,242,600
1294,0,53,3,0,2,20,42,7,2,5,14,112,45,305,1,2,308,199,507
1295,2,60,2,1,2,23,43,5,9,2,19,160,28,356,6,1,363,237,600
1296,2,48,3,2,4,40,51,5,3,4,31,145,24,362,2,1,365,235,600
1297,0,48,0,0,0,27,56,3,3,1,25,159,40,362,6,1,369,231,600
1298,0,60,1,0,5,39,44,4,6,5,19,153,25,361,6,2,369,231,600
1299,0,43,0,1,1,47,40,3,3,7,22,162,29,358,6,0,364,236,600
1300,1,53,1,0,3,40,42,4,6,1,28,145,29,353,2,1,356,244,600
1311,1,42,0,1,5,33,44,8,5,2,25,132,21,319,7,0,326,274,600
1312,2,42,2,0,2,38,30,3,2,2,19,149,24,315,3,0,318,282,600
1313,3,44,0,0,6,50,36,5,4,0,18,135,21,322,8,0,330,270,600
1314,2,38,0,0,4,35,32,4,5,3,15,95,14,247,11,0,258,242,500
1315,0,33,2,3,0,21,31,6,1,2,20,138,27,284,2,0,286,214,500
1316,4,30,0,0,3,21,38,5,2,5,9,128,37,282,6,2,290,260,550
1317,0,27,1,1,3,22,34,2,6,2,18,136,15,267,5,0,272,253,525
1318,1,131,2,0,3,27,70,5,2,6,27,87,78,439,0,0,439,161,600
1319,0,114,0,0,4,41,78,7,5,1,20,105,69,444,1,0,445,155,600
1320,1,124,1,0,7,27,71,6,2,3,27,88,101,458,1,0,459,141,600
1321,0,120,4,0,1,48,57,4,2,4,22,100,74,436,1,1,438,162,600
1322,0,115,3,1,7,34,70,5,4,0,26,95,74,434,3,0,437,163,600
1323,1,145,2,1,3,43,57,2,9,0,21,94,76,454,2,1,457,143,600
1324,1,137,2,0,5,40,76,4,2,1,17,86,75,446,0,0,446,154,600
1325,1,115,5,1,6,55,69,3,8,3,19,76,85,446,2,0,448,152,600
1326,0,113,1,0,6,36,90,3,2,3,29,85,82,450,0,1,451,149,600
1327,0,138,2,0,2,32,71,7,5,2,29,84,81,453,0,0,453,146,599
1328,1,139,1,0,0,30,78,4,4,2,21,89,65,434,1,0,435,165,600
1329,0,118,2,2,4,52,77,2,3,1,23,86,89,459,6,1,466,134,600
1330,2,148,1,1,3,33,69,7,4,2,10,104,74,458,1,1,460,140,600
1331,2,114,3,4,1,40,80,2,1,2,39,92,75,455,4,0,459,141,600
1332,3,125,1,2,4,31,80,6,4,0,21,78,81,436,1,0,437,163,600
1333,2,124,0,1,2,35,91,8,5,2,16,79,81,446,2,1,449,151,600
1334,0,88,1,3,1,31,66,6,6,1,15,87,60,365,1,0,366,134,500
1335,2,108,0,1,1,29,78,2,2,1,15,69,59,367,3,0,370,130,500
1336,0,126,1,1,3,36,54,4,5,3,12,67,78,390,1,0,391,109,500
1337,1,91,2,0,1,38,72,3,3,0,32,87,52,382,4,0,386,114,500
1338,1,119,0,2,5,30,67,2,2,1,26,68,78,401,2,0,403,106,509
1339,0,120,1,2,6,34,66,3,6,2,22,128,72,462,1,0,463,137,600
1340,2,130,2,0,1,43,66,7,4,7,24,102,54,442,2,3,447,153,600
1341,0,128,1,1,5,31,73,6,2,2,26,116,61,452,1,0,453,147,600
1342,1,136,1,0,5,37,77,5,1,4,26,99,51,443,3,0,446,154,600
1343,0,118,2,0,7,28,56,3,1,1,32,122,61,431,4,0,435,165,600
1344,3,133,3,0,4,36,62,5,2,3,23,97,69,440,4,0,444,168,612
1345,5,106,5,1,5,33,83,6,3,4,20,100,59,430,5,2,437,172,609
1346,2,115,1,1,6,33,76,1,1,1,40,109,62,448,6,0,454,153,607
1347,0,147,2,1,1,26,77,7,3,1,24,90,53,432,1,0,433,174,607
1348,1,117,2,0,3,47,73,5,4,3,18,89,52,414,1,1,416,191,607
1349,3,133,1,1,2,40,107,0,3,3,30,67,75,465,1,0,466,141,607
1350,3,116,1,1,3,33,69,4,1,0,27,116,70,444,1,1,446,161,607
1351,0,103,2,3,3,20,97,3,3,0,24,85,61,404,3,0,407,200,607
1352,0,93,2,2,2,32,79,2,5,2,25,106,59,409,3,0,412,195,607
1353,0,52,0,0,1,16,80,8,0,1,34,58,32,282,3,1,286,164,450
1354,1,66,0,0,2,18,66,7,1,2,23,77,29,292,1,2,295,176,471
1355,2,117,2,1,4,50,49,1,6,3,16,131,44,426,4,1,431,169,600
1356,2,108,2,2,1,26,72,4,5,1,24,126,62,435,2,0,437,163,600
1357,4,104,7,1,2,36,68,2,7,2,20,136,56,445,3,0,448,152,600
1358,1,107,3,0,3,40,48,7,4,3,20,142,49,427,4,2,433,167,600
1359,2,106,2,1,5,25,63,9,6,4,28,121,54,426,1,1,428,172,600
1360,2,108,2,2,4,32,50,5,4,2,22,118,54,405,0,0,405,195,600
1361,1,117,2,0,4,27,53,4,3,8,20,130,52,421,2,0,423,177,600
1362,1,97,2,1,4,39,55,3,2,6,21,133,44,408,2,2,412,187,599
1363,1,116,2,1,4,34,47,1,6,2,22,137,47,420,2,0,422,178,600
1364,1,95,2,0,4,39,65,5,9,0,22,118,41,401,2,1,404,196,600
1365,5,128,1,1,5,32,58,13,6,3,15,118,51,436,0,0,436,164,600
1366,0,103,1,2,1,35,63,4,1,2,22,112,48,394,3,0,397,203,600
1367,1,111,4,0,5,34,70,6,3,2,17,109,56,418,3,0,421,179,600
1368,2,79,0,0,5,25,46,5,2,3,18,120,34,339,1,1,341,159,500
1369,0,86,4,3,4,25,50,3,3,2,25,103,29,337,2,1,340,160,500
1370,3,70,0,0,2,31,64,1,0,7,25,99,40,342,1,1,344,156,500
1371,1,95,3,0,5,29,64,3,5,2,23,91,31,352,4,0,356,142,498
1372,2,141,0,0,6,22,60,6,3,2,24,107,85,458,2,0,460,140,600
1373,1,123,0,1,5,38,51,1,8,4,21,115,71,439,2,0,441,159,600
1374,3,125,1,2,4,27,67,4,2,1,22,121,72,451,3,0,454,146,600
1375,1,113,1,1,0,44,59,3,6,3,19,131,74,455,2,0,457,143,600
1376,2,155,1,1,2,48,61,6,2,1,18,92,66,455,5,0,460,140,600
1377,3,119,1,2,6,43,54,5,5,4,12,122,75,451,4,1,456,144,600
1378,1,115,2,2,7,38,90,0,2,1,26,109,64,457,5,0,462,138,600
1379,0,156,2,1,1,38,61,3,4,3,16,89,67,441,4,0,445,155,600
1380,2,135,3,1,3,36,74,6,2,2,22,112,58,456,5,0,461,139,600
1381,0,113,3,0,5,35,58,4,4,5,25,129,74,455,4,1,460,140,600
1382,1,128,2,2,9,47,70,6,7,2,19,106,67,466,0,0,466,134,600
1383,6,138,5,2,2,46,44,5,2,1,16,113,80,460,3,1,464,136,600
1384,0,143,8,2,2,43,63,8,5,3,20,85,80,462,1,1,464,136,600
1385,0,140,2,0,2,44,82,6,3,1,27,93,62,462,1,0,463,137,600
1386,2,129,3,2,4,43,57,6,0,5,18,115,58,442,2,1,445,155,600
1387,2,121,7,1,3,48,61,3,5,1,17,114,72,455,5,1,461,139,600
1388,0,152,3,1,4,38,71,1,1,3,15,125,48,462,6,0,468,132,600
1389,0,100,5,0,2,45,55,7,4,2,10,123,61,414,3,0,417,183,600
1390,2,147,5,0,7,50,55,9,1,1,21,90,47,435,1,0,436,164,600
1391,1,109,3,0,4,56,61,3,3,3,19,112,65,439,2,0,441,159,600
1392,3,138,1,0,5,41,76,4,3,2,22,99,76,470,0,0,470,130,600
1393,0,129,0,0,4,43,69,4,4,6,19,93,63,434,1,1,436,164,600
1394,0,121,1,1,4,44,54,4,4,4,22,113,62,434,3,0,437,163,600
1395,1,138,1,0,2,35,74,2,4,2,25,71,69,424,6,0,430,170,600
1396,5,125,4,0,2,34,73,8,2,2,15,101,67,438,1,0,439,161,600
1397,1,127,4,1,2,24,66,1,2,4,20,99,77,428,5,1,434,166,600
1398,0,145,0,0,5,37,59,3,7,1,15,103,75,450,3,0,453,147,600
1399,3,127,4,0,0,43,79,4,4,1,22,87,79,453,3,1,457,140,597
1400,0,94,3,1,3,28,69,5,1,5,33,116,43,401,7,0,408,192,600
1401,1,103,4,1,1,20,57,4,5,3,22,125,32,378,4,1,383,217,600
1402,2,117,0,0,4,32,50,3,1,1,28,79,41,358,2,0,360,240,600
1403,3,113,0,1,1,27,62,7,2,1,19,101,49,386,3,0,389,211,600
1404,0,96,1,2,0,22,65,5,2,1,22,112,57,385,2,0,387,213,600
1405,3,99,1,2,0,31,57,4,4,3,23,109,45,381,4,0,385,215,600
1406,1,79,0,1,1,30,51,9,2,3,20,99,35,331,3,0,334,216,550
1407,1,75,1,0,1,36,51,4,4,4,26,68,43,314,9,1,324,186,510
1408,2,48,0,1,3,11,44,2,4,1,19,41,29,205,1,0,206,194,400
1409,0,20,0,0,3,8,40,12,1,0,29,40,19,172,1,1,174,167,341
1410,2,119,2,0,4,30,120,2,4,5,32,50,49,419,1,1,421,179,600
1411,1,172,0,0,4,44,67,2,3,3,24,53,65,438,2,0,440,160,600
1412,0,137,1,1,0,32,83,3,6,4,27,56,61,411,0,0,411,189,600
1413,4,153,1,1,0,49,78,0,1,3,29,34,75,428,2,0,430,170,600
1414,1,124,1,1,5,42,93,4,1,2,31,42,74,421,4,0,425,175,600
1415,0,131,1,1,1,41,64,4,3,1,21,53,52,373,2,1,376,174,550
1416,1,135,1,0,1,34,80,4,3,0,28,44,35,366,2,0,368,175,543
1417,0,126,0,0,5,36,61,3,3,0,21,31,55,341,0,1,342,158,500
1418,1,106,1,0,4,37,70,2,1,3,16,20,41,302,1,1,304,176,480
1419,1,99,2,0,1,33,80,2,0,0,19,58,87,382,5,0,387,113,500
1420,0,80,4,0,1,20,64,1,0,2,11,43,74,300,1,0,301,110,411
1421,0,96,1,1,4,23,126,3,4,4,14,39,30,345,5,0,350,150,500
1422,0,117,2,0,6,25,90,1,0,4,21,40,51,357,0,0,357,143,500
1423,1,119,0,1,3,43,59,1,0,3,13,53,63,359,1,0,360,155,515
1424,0,3,0,0,1,4,12,1,0,0,3,3,3,30,0,0,30,14,44
1425,2,67,2,0,4,58,94,1,1,2,17,41,72,361,4,0,365,208,573
1426,0,6,0,0,0,11,37,0,1,0,12,10,8,85,2,1,88,75,163
1427,0,3,0,0,0,9,9,0,0,1,4,3,3,32,0,0,32,72,104
1428,1,67,0,0,0,34,69,1,1,2,27,37,29,268,2,2,272,121,393
1429,2,45,2,0,2,30,97,4,4,1,25,25,30,267,7,0,274,126,400
1430,1,53,1,0,0,22,66,1,3,3,12,25,35,222,4,0,226,125,351
1431,0,100,1,1,4,51,106,0,1,4,36,50,78,432,3,0,435,157,592
1432,0,91,1,1,1,41,86,2,2,1,20,85,73,404,4,0,408,192,600
1433,2,71,0,1,3,35,72,3,3,1,13,75,53,332,3,2,337,163,500
1434,1,56,1,1,2,32,75,3,1,2,14,77,74,339,7,0,346,154,500
1435,0,75,1,0,2,30,74,3,2,3,17,72,53,332,0,0,332,168,500
1436,0,21,0,0,1,12,38,0,0,2,7,34,38,153,0,0,153,73,226
1437,2,44,0,0,1,60,35,0,0,1,11,43,25,222,3,2,227,121,348
1438,0,29,1,0,4,26,94,1,2,2,11,26,51,247,4,1,252,142,394
1439,0,90,0,0,3,31,33,1,1,2,29,25,33,248,7,0,255,181,436
1440,3,65,3,1,0,29,21,6,1,1,12,46,12,200,5,0,205,207,412
1441,0,22,0,0,2,30,36,1,0,0,7,12,3,113,0,0,113,51,164
1442,0,26,0,0,0,12,12,0,0,1,2,13,6,72,0,0,72,81,153
1443,2,39,1,0,1,28,39,0,0,1,9,30,44,194,3,2,199,142,341
1444,1,44,0,0,2,30,36,0,2,0,11,38,27,191,1,0,192,158,350
1445,0,42,1,1,4,27,37,3,0,0,12,33,45,205,3,0,208,134,342
1446,2,52,0,2,2,22,36,0,0,1,6,25,9,157,5,2,164,139,303
1447,0,10,0,0,2,16,30,2,0,0,1,57,22,140,5,0,145,94,239
1448,0,3,0,0,0,8,32,0,0,1,1,1,3,49,1,0,50,57,107
1449,0,4,1,0,0,3,5,0,0,0,0,9,9,31,1,0,32,43,75
1450,2,18,0,1,0,11,15,1,0,4,4,7,6,69,0,1,70,37,107
1451,0,27,0,0,0,6,18,0,0,1,2,16,34,104,2,1,107,84,191
1452,1,47,0,0,2,10,29,2,0,1,7,13,7,119,0,1,120,81,201
1453,0,99,0,1,3,44,93,2,4,2,12,63,122,445,1,0,446,154,600
1454,1,98,0,0,2,43,90,6,3,3,14,70,90,420,1,1,422,177,599
1455,0,120,1,0,5,42,88,4,2,4,22,55,81,424,2,0,426,174,600
1456,0,115,2,0,4,50,90,3,2,0,9,69,99,443,1,0,444,156,600
1457,0,138,1,0,5,44,77,1,6,1,13,63,92,441,0,0,441,159,600
1458,2,123,1,2,3,44,81,4,4,1,9,78,74,426,3,0,429,171,600
1459,2,116,0,2,2,39,95,3,5,4,11,62,100,441,2,3,446,154,600
1460,1,132,2,0,4,35,94,6,2,0,11,61,74,422,0,2,424,176,600
1461,0,131,2,2,6,30,83,2,4,0,10,76,90,436,2,0,438,162,600
1462,0,126,2,1,6,26,91,4,3,1,9,58,103,430,1,0,431,169,600
1463,0,135,4,1,4,39,84,8,9,0,10,61,74,429,1,0,430,170,600
1464,0,112,0,1,2,50,88,6,5,1,5,66,81,417,3,0,420,180,600
1465,0,116,2,0,2,44,83,2,3,1,9,79,82,423,3,1,427,173,600
1466,0,112,4,1,1,36,98,3,2,1,12,75,81,426,2,0,428,172,600
1467,1,112,3,0,2,35,79,4,5,1,8,77,95,422,0,0,422,178,600
1468,0,131,2,1,7,31,92,4,5,3,14,44,96,430,2,1,433,167,600
1469,0,116,3,0,4,36,73,7,6,2,10,63,102,422,1,1,424,176,600
1470,1,137,1,0,4,40,93,1,11,0,9,63,85,445,1,0,446,154,600
1471,0,116,2,3,3,40,92,2,8,1,11,78,95,451,1,0,452,148,600
1472,0,126,5,0,1,43,89,3,4,2,14,72,96,455,1,0,456,144,600
1473,1,128,0,0,1,36,97,2,1,2,23,50,104,445,2,0,447,153,600
1474,0,120,2,0,3,47,87,6,6,1,8,70,98,448,2,0,450,150,600
1475,0,110,7,1,5,37,92,3,3,2,9,61,100,430,3,0,433,167,600
1476,0,120,2,1,4,34,84,3,3,1,18,65,85,420,1,0,421,179,600
1477,0,126,2,2,1,37,79,0,4,2,10,50,104,417,1,0,418,132,550
1478,0,112,1,0,1,31,78,1,4,1,13,43,96,381,5,0,386,139,525
1479,3,124,4,0,3,37,75,9,3,1,27,90,54,430,2,0,432,168,600
1480,0,124,2,2,0,33,68,5,5,1,21,89,77,427,3,0,430,170,600
1481,2,141,3,1,0,40,74,6,3,4,15,79,70,438,2,0,440,160,600
1482,1,128,3,0,6,28,75,2,5,2,20,70,83,423,1,0,424,176,600
1483,2,129,3,0,5,50,71,5,2,0,15,79,77,438,6,0,444,156,600
1485,4,129,3,0,2,32,74,1,2,1,11,93,74,426,0,0,426,174,600
1486,1,112,1,0,1,32,53,6,5,4,12,75,61,363,4,0,367,133,500
1487,0,105,1,1,2,29,71,3,2,0,12,78,65,369,3,1,373,127,500
1488,0,104,2,2,2,41,70,7,5,0,14,65,57,369,1,1,371,129,500
1489,2,128,3,1,3,55,64,3,3,2,11,66,65,406,2,0,408,134,542
1490,2,69,2,2,5,45,66,5,1,0,13,121,69,400,3,0,403,197,600
1491,1,69,3,0,1,44,59,4,3,1,13,104,73,375,2,0,377,223,600
1492,1,62,0,1,2,46,66,2,3,6,28,113,49,379,4,0,383,217,600
1493,1,75,3,0,1,48,51,4,4,1,18,107,46,359,3,0,362,238,600
1494,0,75,1,4,2,41,51,3,3,0,15,95,79,369,1,2,372,228,600
1495,0,59,3,0,4,44,64,1,2,0,11,95,60,343,1,0,344,256,600
1496,2,97,2,0,2,40,44,3,2,1,13,117,56,379,6,0,385,215,600
1497,3,75,1,1,3,42,72,2,1,2,13,98,58,371,2,1,374,226,600
1498,1,83,3,0,2,49,44,5,1,0,12,98,73,371,2,1,374,226,600
1499,1,69,3,1,7,41,49,6,0,5,18,103,61,364,1,0,365,235,600
1500,4,64,0,1,2,37,45,4,4,0,19,85,61,326,5,0,331,169,500
1501,3,67,1,0,2,44,38,6,3,0,9,80,42,295,8,0,303,197,500
1502,0,69,3,0,1,32,64,8,5,2,15,73,57,329,1,0,330,194,524
1503,0,111,1,0,3,50,89,7,3,2,9,60,94,429,0,0,429,171,600
1504,1,124,1,1,6,34,107,1,7,0,15,64,78,439,2,0,441,159,600
1505,0,134,2,2,4,35,82,2,3,4,8,62,104,442,1,0,443,157,600
1506,2,144,1,0,4,34,102,3,1,1,12,63,93,460,1,0,461,139,600
1507,0,136,3,1,0,34,79,2,6,2,13,72,94,442,1,1,444,156,600
1508,1,135,4,0,3,40,78,4,4,4,10,72,99,454,3,0,457,143,600
1509,1,130,2,1,3,35,81,2,3,0,11,81,91,441,0,0,441,159,600
1510,0,152,2,1,4,26,79,6,5,1,13,69,93,451,5,3,459,141,600
1511,0,137,0,2,2,35,95,3,7,3,18,65,83,450,3,0,453,147,600
1512,0,147,2,0,5,36,67,1,3,3,13,73,91,441,4,1,446,154,600
1513,2,125,2,0,4,29,88,3,5,2,12,66,109,447,1,0,448,152,600
1514,1,112,0,0,1,20,75,1,4,0,8,52,96,370,1,0,371,129,500
1515,0,110,1,1,2,25,86,5,1,0,10,45,85,371,3,1,375,125,500
1516,0,93,1,0,2,15,69,5,2,2,18,54,90,351,1,0,352,148,500
1517,1,122,2,0,3,36,63,3,4,0,7,67,89,397,3,0,400,130,530
1518,1,42,5,1,2,38,56,7,4,1,21,162,24,364,6,0,370,230,600
1519,4,43,2,0,0,44,52,3,2,2,21,139,36,348,5,1,354,239,593
1520,0,43,2,1,1,29,47,6,0,4,16,160,37,346,3,1,350,250,600
1521,0,35,4,0,1,30,57,7,2,3,10,154,38,341,6,2,349,251,600
1522,2,36,3,0,1,19,59,9,1,2,14,163,36,345,3,0,348,252,600
1523,2,48,0,0,1,34,47,8,3,2,17,151,44,357,6,0,363,237,600
1524,1,50,0,1,5,26,40,2,3,2,17,172,27,346,3,2,351,249,600
1525,2,46,1,1,1,44,46,7,1,1,13,169,28,360,2,1,363,237,600
1526,2,46,1,0,3,35,31,4,3,4,23,153,42,347,3,1,351,249,600
1527,1,36,0,3,4,15,52,2,1,7,24,176,30,351,8,2,361,239,600
1528,1,49,2,1,4,30,59,6,3,3,24,142,26,350,8,1,359,241,600
1529,3,40,1,0,1,23,55,2,2,3,14,132,37,313,2,0,315,185,500
1530,5,54,5,1,0,35,39,2,3,2,19,114,40,319,6,2,327,213,540
1531,1,106,2,0,5,40,56,4,2,3,11,115,60,405,2,0,407,193,600
1532,2,91,1,1,1,46,91,2,2,2,15,109,81,444,3,1,448,152,600
1533,2,97,1,1,7,40,65,3,4,2,14,112,64,412,3,0,415,185,600
1534,2,93,0,0,4,47,69,7,3,2,20,99,78,424,2,0,426,174,600
1535,1,106,1,1,1,36,49,6,3,3,14,126,77,424,0,1,425,175,600
1536,0,101,1,2,2,40,75,5,3,1,10,96,85,421,2,1,424,176,600
1537,1,88,1,1,5,40,60,7,1,3,16,95,60,378,1,1,380,144,524
1538,0,127,2,0,4,49,71,3,2,3,10,102,68,441,2,1,444,156,600
1539,2,148,4,0,2,26,73,10,1,1,14,85,70,436,2,0,438,162,600
1540,0,110,1,1,8,29,66,3,6,0,8,128,74,434,1,0,435,165,600
1541,1,103,0,0,2,49,77,5,6,0,16,111,74,444,1,0,445,155,600
1542,1,105,0,1,1,43,65,5,6,1,14,103,75,420,2,1,423,177,600
1543,1,125,0,0,1,36,65,5,5,3,18,105,66,430,3,0,433,167,600
1544,1,131,2,0,1,40,76,6,8,3,13,100,63,444,0,0,444,156,600
1545,1,119,2,1,5,41,77,2,3,1,12,105,60,429,1,0,430,170,600
1546,1,103,0,0,3,35,58,3,7,2,21,73,68,374,2,0,376,124,500
1547,1,110,2,0,5,36,52,6,6,2,15,75,59,369,0,0,369,131,500
1548,0,116,1,2,0,18,72,4,3,1,8,87,54,366,1,0,367,163,530
1549,1,160,4,0,1,39,72,0,5,1,7,60,116,466,2,1,469,131,600
1550,1,115,3,1,8,46,91,3,5,4,7,52,115,451,2,0,453,147,600
1551,1,143,2,1,4,34,80,4,6,0,13,70,90,448,0,0,448,152,600
1552,1,149,0,0,9,48,74,4,2,2,9,67,104,469,1,0,470,130,600
1553,1,143,3,0,4,36,83,6,4,0,6,54,123,463,1,0,464,136,600
1554,1,135,1,0,6,44,85,1,5,1,6,47,118,450,2,1,453,147,600
1555,1,147,1,0,7,27,87,3,4,2,4,66,110,459,3,0,462,138,600
1556,1,146,2,2,5,34,63,4,7,3,19,56,93,435,2,1,438,162,600
1557,0,132,0,2,6,36,75,2,4,0,13,60,114,444,2,2,448,152,600
1558,0,163,1,3,3,25,83,3,3,2,9,66,98,459,0,0,459,141,600
1559,1,162,3,1,7,24,81,1,6,0,14,57,92,449,1,0,450,150,600
1560,0,130,1,0,1,28,105,11,4,2,7,55,103,447,1,1,449,151,600
1561,1,140,2,0,3,34,107,3,7,0,9,69,104,479,0,0,479,121,600
1562,1,121,1,0,5,30,98,3,8,0,9,72,104,452,2,0,454,146,600
1563,1,140,2,0,3,40,83,1,7,2,13,75,95,462,1,0,463,137,600
1564,0,123,2,3,0,27,85,5,4,1,14,78,126,468,0,0,468,132,600
1565,1,143,0,2,2,30,68,5,4,1,10,62,137,465,2,1,468,132,600
1566,0,148,5,2,3,30,68,7,1,0,7,55,113,439,0,0,439,161,600
1567,0,130,1,0,4,39,96,6,2,4,8,74,94,458,2,0,460,140,600
1568,1,132,2,0,2,37,81,4,2,2,14,53,116,446,2,0,448,152,600
1569,1,147,0,0,2,48,85,3,2,2,9,57,104,460,2,0,462,138,600
1570,2,145,0,2,8,32,82,4,8,0,13,63,108,467,4,0,471,129,600
1571,0,152,0,1,1,20,87,2,2,1,12,63,124,465,4,0,469,131,600
1572,1,136,3,0,8,32,85,4,7,2,8,61,104,451,0,0,451,149,600
1573,1,131,1,1,4,31,87,1,3,2,11,46,124,443,2,0,445,155,600
1574,1,110,1,0,2,40,89,4,5,1,12,69,91,425,1,1,427,173,600
1575,1,125,0,1,3,43,84,5,9,1,1,65,121,459,2,0,461,139,600
1576,3,147,2,1,7,38,65,7,3,4,12,66,122,477,1,0,478,122,600
1577,0,137,0,0,7,31,94,4,4,1,11,56,107,452,1,0,453,147,600
1578,1,131,0,1,2,30,83,9,6,2,13,60,107,445,2,0,447,153,600
1579,1,154,0,1,3,40,91,4,2,2,12,56,93,459,2,0,461,139,600
1580,0,146,2,1,11,32,78,2,3,1,10,60,100,446,0,0,446,154,600
1581,0,152,0,0,12,32,87,4,4,0,8,35,100,434,2,2,438,162,600
1582,0,128,3,0,2,41,67,4,7,3,10,54,107,426,6,0,432,168,600
1583,0,118,3,0,0,28,83,1,3,3,9,47,114,409,3,0,412,138,550
1584,1,115,1,0,2,27,74,1,5,1,11,56,107,401,1,0,402,98,500
1585,0,112,0,1,5,30,68,8,4,1,2,51,110,392,2,1,395,105,500
1586,1,117,2,0,5,37,69,4,2,1,6,55,100,399,2,0,401,137,538
1587,0,1,0,0,0,1,3,3,0,1,1,0,2,12,0,0,12,13,25
1588,0,112,2,1,3,34,74,8,2,1,7,126,62,432,1,0,433,167,600
1589,3,102,2,0,1,31,78,2,6,4,21,106,61,417,4,8,429,170,599
1590,1,102,1,0,3,24,86,8,4,3,16,104,58,410,4,0,414,186,600
1591,0,108,2,0,0,33,61,9,2,1,17,133,66,432,7,0,439,161,600
1592,0,130,1,0,2,30,78,5,2,0,19,114,70,451,3,0,454,146,600
1593,0,97,1,1,6,32,56,0,5,2,11,87,59,357,1,0,358,140,498
1594,0,108,1,1,1,43,62,10,9,3,20,80,77,415,3,0,418,182,600
1595,1,123,1,2,4,47,59,8,1,4,21,83,59,413,3,1,417,183,600
1596,4,114,1,0,1,45,69,2,0,0,30,71,72,409,7,0,416,184,600
1597,1,128,1,0,0,36,68,5,5,3,22,83,57,409,1,0,410,174,584
1598,5,78,1,0,3,34,47,1,2,2,12,80,41,306,1,0,307,193,500
1599,2,83,0,0,3,30,34,4,3,0,10,118,59,346,3,0,349,151,500
1600,5,89,2,0,2,38,48,2,7,1,17,96,41,348,1,0,349,151,500
1601,5,87,0,0,1,27,46,2,5,1,10,69,38,291,7,0,298,142,440
1602,0,149,0,0,10,40,42,4,5,8,20,91,93,462,2,0,464,136,600
1603,0,92,1,0,0,34,63,5,4,2,23,106,74,404,0,0,404,196,600
1604,0,97,0,0,1,37,53,3,5,4,8,116,93,417,1,1,419,181,600
1605,1,111,6,0,1,45,48,2,1,4,21,109,77,426,0,0,426,174,600
1606,0,118,3,0,3,45,70,2,3,3,19,117,72,455,1,0,456,144,600
1607,1,125,1,1,2,42,71,1,2,1,18,86,81,432,2,0,434,166,600
1608,1,111,0,2,1,44,62,5,4,4,20,89,74,417,4,0,421,179,600
1609,3,117,1,0,4,41,63,3,2,1,16,108,71,430,4,0,434,166,600
1610,1,90,2,2,5,34,64,7,2,6,17,123,76,429,1,0,430,170,600
1611,1,109,0,1,2,41,79,3,4,3,18,100,54,415,3,0,418,182,600
1612,1,120,3,2,3,48,55,7,1,1,18,112,61,432,1,1,434,166,600
1613,0,112,2,2,1,33,50,4,9,3,13,109,74,412,1,0,413,187,600
1614,1,121,1,0,5,34,70,4,4,2,19,104,69,434,0,0,434,166,600
1615,0,100,2,1,5,44,67,2,4,6,16,95,83,425,0,0,425,175,600
1616,1,119,0,2,9,37,48,3,4,0,24,108,66,421,2,0,423,177,600
1617,3,121,0,1,2,39,47,2,6,5,20,92,70,408,3,0,411,189,600
1618,2,123,1,2,3,51,68,3,2,2,13,99,75,444,0,1,445,155,600
1619,1,102,1,0,0,40,42,3,6,3,10,72,74,354,1,0,355,142,497
1620,2,74,5,2,3,33,49,7,4,0,10,154,39,382,7,0,389,211,600
1621,0,59,4,2,4,36,68,3,6,1,11,129,36,359,5,1,365,135,500
1622,1,65,3,0,3,36,53,5,3,6,19,113,28,335,4,1,340,160,500
1623,1,67,4,0,4,28,52,0,3,2,6,131,41,339,4,0,343,157,500
1624,2,78,5,1,5,32,61,2,2,2,22,127,43,382,4,1,387,163,550
1625,1,73,4,0,7,29,42,3,3,4,17,134,49,366,7,0,373,154,527
1626,0,150,2,1,1,20,71,2,3,2,15,45,95,407,2,0,409,191,600
1627,0,141,4,1,6,33,64,2,1,1,8,42,109,412,2,0,414,186,600
1628,1,162,2,0,4,18,82,1,3,1,8,36,120,438,5,1,444,156,600
1629,0,155,0,1,5,31,75,3,4,0,5,35,117,431,1,2,434,166,600
1630,1,142,1,0,8,32,71,4,3,1,12,38,103,416,7,2,425,175,600
1631,0,143,0,0,1,29,105,2,0,1,13,36,98,428,0,0,428,172,600
1632,0,144,1,0,5,34,68,3,1,1,11,37,100,405,2,0,407,193,600
1633,1,146,0,0,7,20,66,6,4,1,7,31,116,405,1,0,406,194,600
1634,0,164,3,0,5,19,74,3,2,4,10,54,87,425,1,0,426,174,600
1635,0,161,1,2,5,38,70,5,5,7,11,43,84,432,5,0,437,163,600
1636,1,150,4,1,4,19,83,5,1,1,2,37,127,435,1,0,436,164,600
1637,0,148,1,0,4,31,64,5,2,3,12,37,108,415,2,0,417,183,600
1638,1,163,3,2,10,24,61,2,3,2,6,32,87,396,3,0,399,201,600
1639,1,156,1,1,2,30,72,4,5,8,16,41,98,435,1,1,437,163,600
1640,0,132,0,1,5,21,74,4,1,0,14,41,123,416,4,0,420,180,600
1641,1,135,2,0,5,31,64,4,1,0,13,41,86,383,3,0,386,158,544
1642,2,157,1,0,1,41,78,4,6,1,7,64,72,434,5,0,439,161,600
1643,1,145,1,1,7,21,75,1,5,3,10,64,87,421,5,1,427,173,600
1644,0,151,1,2,5,34,79,3,4,0,5,51,96,431,1,2,434,166,600
1645,0,155,0,2,4,36,64,5,6,3,6,55,98,434,0,0,434,166,600
1646,0,161,2,2,3,40,78,1,6,1,7,59,95,455,0,0,455,145,600
1647,0,153,1,5,7,30,81,5,3,5,12,53,87,442,3,0,445,155,600
1648,0,144,2,2,1,40,79,4,1,3,7,44,124,451,3,0,454,146,600
1649,1,175,0,1,7,32,72,5,3,1,10,55,105,467,2,0,469,131,600
1650,1,154,3,5,3,36,60,2,5,3,10,59,91,432,3,1,436,164,600
1651,0,149,1,0,4,24,68,4,0,3,11,62,80,406,3,0,409,191,600
1652,0,167,1,1,2,41,67,3,2,1,10,59,92,446,1,0,447,153,600
1653,1,176,3,0,3,29,88,2,8,1,10,38,97,456,2,0,458,142,600
1654,1,154,0,1,1,24,93,4,5,2,13,47,81,426,1,1,428,172,600
1655,0,139,3,2,4,45,85,6,2,1,8,53,93,441,1,0,442,158,600
1656,1,139,1,0,2,31,67,3,3,0,2,56,69,374,2,1,377,123,500
1657,0,137,2,0,5,35,50,3,5,0,7,58,74,376,1,0,377,123,500
1658,0,126,2,0,3,39,57,3,5,2,4,47,71,359,4,2,365,135,500
1659,0,142,2,1,5,23,59,1,2,1,9,58,68,371,3,0,374,126,500
1660,0,160,0,0,4,24,64,2,2,0,7,47,63,373,0,2,375,125,500
1661,2,165,1,1,9,38,68,1,6,1,9,45,60,406,2,1,409,142,551
1662,2,17,0,1,1,1,22,1,1,0,1,2,5,54,0,1,55,23,78
1663,1,174,1,0,6,40,72,4,5,3,11,39,97,453,1,1,455,145,600
1664,0,176,3,0,4,22,82,4,6,2,8,59,98,464,2,2,468,132,600
1665,0,183,1,2,4,36,50,2,13,2,12,59,100,464,2,0,466,134,600
1666,0,161,1,1,2,39,83,6,2,3,9,38,109,454,3,1,458,142,600
1667,2,154,1,3,2,31,87,4,3,1,7,51,104,450,2,0,452,148,600
1668,2,159,2,0,3,33,101,4,5,0,7,33,111,460,0,1,461,139,600
1669,0,178,0,0,3,34,82,7,4,0,7,57,110,482,0,0,482,118,600
1670,2,162,0,1,11,28,91,2,5,1,8,46,109,466,5,0,471,129,600
1671,0,153,0,1,6,36,76,6,4,0,14,52,117,465,0,0,465,135,600
1672,0,135,0,1,7,27,66,2,5,2,10,28,97,380,2,1,383,117,500
1673,0,153,0,0,3,21,50,2,7,3,7,34,89,369,6,1,376,124,500
1674,0,149,1,0,4,20,64,6,7,3,4,48,95,401,1,0,402,98,500
1675,1,127,2,1,5,28,76,2,2,0,5,50,97,396,1,0,397,103,500
1676,1,155,2,2,7,14,61,9,2,2,11,44,100,410,2,0,412,138,550
1677,0,131,4,0,8,38,76,2,2,1,6,43,74,385,1,0,386,127,513
1678,0,182,1,1,9,28,72,3,9,1,10,58,94,468,0,0,468,132,600
1679,1,143,1,0,6,35,82,4,4,1,19,49,90,435,0,0,435,165,600
1680,2,168,1,0,5,26,72,4,7,4,19,58,87,453,2,3,458,142,600
1681,2,172,2,2,3,27,76,4,7,2,11,69,95,472,2,0,474,126,600
1682,3,178,1,0,5,30,63,8,2,3,8,69,84,454,4,0,458,142,600
1683,4,160,6,0,3,29,61,3,9,3,12,50,70,410,2,0,412,137,549
1684,0,146,0,1,10,22,103,0,6,3,18,63,62,434,3,0,437,163,600
1685,1,203,1,0,12,35,79,0,6,0,14,46,65,462,0,0,462,138,600
1686,1,141,1,3,11,20,63,7,1,0,10,29,76,363,1,2,366,134,500
1687,0,163,2,0,12,19,55,5,0,4,9,45,73,387,1,0,388,112,500
1688,0,136,1,0,6,27,68,3,4,0,22,49,98,414,0,0,414,123,537
1689,3,134,3,1,6,33,71,8,4,0,8,94,92,457,0,0,457,143,600
1690,2,121,1,0,6,33,68,7,3,5,18,70,94,428,3,0,431,169,600
1691,1,145,3,4,4,27,78,1,3,3,15,73,89,446,1,0,447,153,600
1692,0,123,1,2,6,23,86,3,6,3,14,71,115,453,0,0,453,147,600
1693,1,137,0,2,7,51,81,4,2,2,9,60,79,435,4,0,439,161,600
1694,0,126,1,0,6,42,64,7,3,1,11,66,91,418,6,0,424,176,600
1695,0,115,1,1,1,50,76,2,3,0,13,61,75,398,1,1,400,200,600
1696,1,124,2,3,3,26,75,5,7,5,18,62,82,413,4,0,417,183,600
1697,0,123,2,0,4,30,71,1,6,1,27,88,57,410,1,0,411,189,600
1698,1,111,1,0,2,53,67,4,1,3,15,65,94,417,3,0,420,180,600
1699,2,128,0,1,2,42,57,2,4,1,19,54,91,403,3,1,407,162,569
1700,0,39,0,2,0,19,137,3,1,0,5,47,54,307,2,1,310,140,450
1701,0,65,0,0,0,22,117,3,2,1,13,40,50,313,0,0,313,137,450
1703,4,54,0,1,3,31,135,2,0,2,14,27,81,354,2,0,356,160,516
1704,0,57,0,1,1,24,90,2,0,0,19,49,33,276,0,0,276,147,423
1705,1,18,1,3,0,19,131,1,1,1,21,47,28,272,3,0,275,256,531
1706,0,18,0,0,0,6,26,1,0,1,7,5,19,83,2,1,86,32,118
1707,1,8,0,0,0,4,15,0,0,2,9,0,13,52,0,0,52,29,81
1708,0,7,0,0,1,14,73,2,0,0,6,10,18,131,2,2,135,80,215
1709,0,2,0,0,0,4,22,0,0,0,5,5,0,38,0,0,38,39,77
1710,0,7,0,0,0,7,109,5,1,0,7,11,17,164,1,1,166,99,265
1711,0,3,0,0,0,2,31,0,0,0,5,9,18,68,0,0,68,45,113
1712,0,3,0,0,0,2,40,0,0,0,2,19,29,95,0,0,95,92,187
1713,0,21,0,0,0,16,54,1,0,0,4,32,146,274,0,0,274,138,412
1714,0,26,0,0,1,13,58,2,0,0,9,30,27,166,1,1,168,112,280
1715,1,2,0,0,0,1,15,0,0,0,1,5,23,48,1,1,50,23,73
1716,2,120,0,2,9,33,73,2,4,2,26,47,43,363,1,0,364,236,600
1717,1,175,1,0,2,27,62,5,9,3,16,46,55,402,2,2,406,194,600
1718,1,137,1,2,8,32,83,3,0,2,9,36,73,387,4,2,393,207,600
1719,0,122,0,0,4,31,54,1,3,1,15,34,58,323,3,0,326,174,500
1720,1,110,2,2,5,17,65,1,1,2,16,44,30,296,5,0,301,199,500
1721,2,129,0,0,4,21,63,1,3,1,18,20,51,313,7,1,321,179,500
1722,2,137,0,0,3,43,72,1,5,1,16,29,61,370,5,0,375,145,520
1723,2,7,0,0,0,2,12,0,0,1,3,4,2,33,1,0,34,25,59
1724,1,43,0,1,3,12,39,1,1,0,18,30,38,187,4,1,192,117,309
1725,2,121,1,2,1,41,66,2,3,3,23,44,41,350,2,0,352,179,531
1726,0,14,0,0,0,7,75,0,0,2,8,11,17,134,2,0,136,68,204
1727,2,51,3,1,0,13,49,0,0,5,30,22,50,226,2,0,228,82,310
1728,1,34,0,0,1,17,38,1,2,1,19,24,25,163,3,1,167,45,212
1729,0,43,0,0,1,3,13,0,0,0,0,9,21,90,0,1,91,30,121
1730,1,124,0,1,7,46,107,1,7,0,11,53,72,430,0,1,431,169,600
1731,0,112,3,0,5,26,81,3,3,3,13,94,84,427,3,0,430,170,600
1732,2,119,0,1,1,36,89,2,0,4,12,66,89,421,0,0,421,179,600
1733,0,144,6,0,5,40,86,4,5,2,11,55,88,446,3,1,450,150,600
1734,0,128,1,2,1,41,105,4,2,3,8,80,83,458,2,0,460,140,600
1735,2,125,1,1,3,37,85,1,0,3,13,75,93,439,1,1,441,159,600
1736,0,127,3,1,2,28,88,2,4,3,16,68,76,418,1,0,419,181,600
1737,1,121,2,0,3,32,90,4,1,1,10,89,82,436,2,0,438,162,600
1738,2,113,2,0,5,39,64,3,2,1,12,64,102,409,6,2,417,183,600
1739,3,111,1,0,6,49,83,9,5,2,13,65,100,447,1,0,448,152,600
1740,0,116,2,2,2,33,67,4,5,1,14,73,84,403,0,1,404,196,600
1741,2,148,1,0,0,37,75,1,0,1,11,86,74,436,3,0,439,161,600
1742,1,121,1,0,8,37,91,5,1,1,20,65,77,428,3,1,432,168,600
1743,2,101,3,0,3,24,72,7,4,2,14,67,89,388,1,0,389,211,600
1744,1,123,1,2,8,28,70,0,1,0,14,85,89,422,3,0,425,175,600
1745,1,129,2,0,3,39,77,1,4,0,9,65,102,432,0,0,432,168,600
1746,1,143,3,1,5,40,60,2,3,2,10,62,104,436,2,0,438,162,600
1747,0,98,0,0,3,31,87,5,6,0,14,76,106,426,1,0,427,173,600
1748,0,88,4,1,7,41,67,7,3,0,12,64,69,363,4,0,367,133,500
1749,0,111,0,0,3,28,75,3,1,1,14,49,83,368,2,0,370,146,516
1750,2,162,3,1,3,28,93,7,5,1,12,41,100,458,6,0,464,136,600
1751,3,136,5,0,3,21,85,4,3,2,9,79,117,467,1,2,470,130,600
1752,1,129,1,0,4,41,81,7,7,2,8,46,129,456,2,0,458,142,600
1753,0,125,1,1,6,31,74,2,4,1,10,51,85,391,0,0,391,109,500
1754,1,125,0,2,4,21,70,2,6,2,9,48,87,377,2,0,379,121,500
1755,1,139,0,1,2,20,88,3,5,1,9,33,110,412,2,0,414,86,500
1756,0,107,0,2,5,21,54,7,2,1,3,55,80,337,4,1,342,110,452
1757,0,138,2,0,0,15,114,6,5,2,5,41,141,469,2,0,471,129,600
1758,1,145,1,1,3,19,93,3,6,1,17,51,141,482,1,0,483,117,600
1759,0,119,4,1,2,15,78,4,2,1,13,45,94,378,1,0,379,121,500
1760,1,97,0,1,7,26,75,7,1,2,12,63,88,380,4,0,384,116,500
1761,0,108,2,0,2,22,81,2,4,1,12,46,120,400,1,0,401,99,500
1762,0,97,2,0,2,20,75,6,3,2,12,50,115,384,5,0,389,111,500
1763,2,125,1,1,4,17,74,2,5,1,4,48,99,383,3,1,387,106,493
1764,2,141,1,0,2,33,90,4,0,1,11,56,108,449,1,0,450,150,600
1765,0,141,2,3,2,38,62,3,3,3,9,49,113,428,5,1,434,166,600
1766,1,120,4,0,4,38,103,4,6,4,9,52,91,436,4,0,440,160,600
1767,0,120,1,1,3,30,85,4,3,1,12,53,128,441,0,0,441,159,600
1768,1,120,1,1,4,31,81,7,5,2,6,54,119,432,1,0,433,167,600
1769,3,152,0,0,7,37,80,3,3,0,7,48,109,449,1,0,450,150,600
1770,0,101,2,2,3,25,86,2,3,0,6,44,91,365,0,0,365,135,500
1772,0,126,0,0,1,22,67,5,4,3,10,39,110,387,1,2,390,156,546
1773,0,3,0,1,0,2,10,1,1,0,3,1,7,29,0,1,30,14,44
1774,0,103,0,1,3,22,78,3,3,0,18,80,111,422,3,0,425,175,600
1775,0,104,0,2,3,23,72,7,3,2,12,71,109,408,7,4,419,181,600
1776,2,99,4,1,3,24,66,0,1,2,22,87,107,418,4,0,422,178,600
1777,0,108,2,1,2,43,81,5,5,2,11,63,108,431,4,2,437,163,600
1778,1,118,1,3,5,29,65,7,2,1,14,102,81,429,2,0,431,169,600
1779,2,128,4,0,3,21,64,3,3,4,9,77,111,429,0,0,429,171,600
1780,1,103,1,1,2,34,72,3,2,2,17,76,90,404,0,0,404,196,600
1781,1,93,3,1,1,31,83,3,6,2,13,62,118,417,1,1,419,181,600
1782,0,113,1,0,2,30,100,7,5,3,15,72,95,443,3,0,446,154,600
1783,0,101,2,1,4,28,64,4,1,0,16,86,92,399,0,0,399,201,600
1784,1,103,1,0,4,38,67,5,4,0,22,82,98,425,0,0,425,175,600
1785,1,97,0,4,6,33,66,8,2,4,14,90,95,420,3,0,423,177,600
1786,0,108,2,1,8,41,63,0,4,1,20,81,79,408,4,0,412,188,600
1787,5,106,2,0,2,28,72,8,3,1,17,67,101,412,1,1,414,187,601
1788,3,111,1,2,3,33,68,4,3,1,18,94,65,406,1,0,407,143,550
1789,1,88,2,1,5,22,79,8,3,1,23,68,103,404,0,0,404,141,545
1790,0,95,2,1,4,22,131,1,4,0,7,36,175,478,2,0,480,120,600
1791,0,113,0,1,3,22,124,4,3,0,6,45,179,500,3,0,503,97,600
1792,0,95,0,1,4,21,143,3,3,0,2,32,170,474,0,0,474,126,600
1793,0,90,1,0,2,18,112,4,5,0,3,37,190,462,1,0,463,137,600
1794,0,123,2,1,6,26,117,4,6,0,3,35,148,471,0,0,471,129,600
1795,0,91,0,0,4,25,132,5,1,0,2,40,174,474,2,0,476,124,600
1821,1,122,2,0,3,36,45,1,3,4,14,92,76,399,2,0,401,199,600
1822,3,104,2,0,3,35,52,0,5,2,20,91,85,402,4,0,406,194,600
1823,2,99,0,0,2,35,46,3,3,3,15,99,75,382,1,1,384,216,600
1824,0,99,0,3,6,37,44,1,4,3,16,100,66,379,3,0,382,218,600
1825,1,83,0,1,2,37,40,3,5,2,14,86,61,335,3,0,338,162,500
1842,0,6,0,0,1,4,21,1,0,0,4,12,76,125,1,0,126,47,173
1843,1,31,0,1,1,9,24,1,0,2,8,20,35,133,1,0,134,64,198
1844,1,6,0,0,1,10,20,0,0,1,4,7,63,113,0,1,114,59,173
1845,0,28,1,1,2,25,21,3,1,4,15,106,48,255,1,0,256,201,457
1484,0,109,0,3,2,36,87,4,5,0,19,86,84,435,5,1,441,159,600
1702,0,48,1,0,0,23,95,0,0,1,6,31,56,261,1,0,262,140,402
1771,0,96,1,2,4,15,81,6,4,1,16,52,96,374,2,0,376,124,500
1796,0,95,1,0,4,27,110,5,4,0,6,32,174,458,0,0,458,105,563
1797,0,92,1,0,3,16,109,5,0,0,4,27,161,418,0,0,418,82,500
1798,1,119,1,0,4,48,74,4,3,3,12,84,61,414,1,0,415,185,600
1799,3,101,1,0,5,60,62,4,4,5,9,83,66,403,3,0,406,194,600
1800,0,120,1,1,3,42,74,2,5,1,17,89,66,421,2,0,423,177,600
1801,3,103,1,0,8,39,76,5,1,1,10,87,69,403,0,0,403,197,600
1802,2,111,2,0,0,44,70,0,5,4,14,92,73,417,2,0,419,181,600
1803,1,110,0,0,4,47,72,3,6,0,8,66,70,387,2,2,391,209,600
1804,2,99,0,0,4,34,72,1,4,2,25,82,72,397,2,0,399,151,550
1805,3,98,0,0,4,32,86,1,7,1,13,78,53,376,1,0,377,169,546
1806,3,31,1,1,2,25,44,8,3,1,18,181,37,355,0,0,355,245,600
1807,3,38,4,0,0,45,43,6,3,2,20,139,28,331,5,0,336,264,600
1808,2,54,2,1,1,22,66,6,1,3,10,158,22,348,1,0,349,251,600
1809,3,41,3,1,0,38,55,8,1,1,16,150,26,343,5,0,348,252,600
1810,6,43,3,1,1,38,47,3,1,3,22,149,25,342,8,0,350,250,600
1811,3,40,1,0,5,22,56,3,5,1,31,146,28,341,5,1,347,253,600
1812,3,42,1,0,2,31,45,6,0,0,13,121,17,281,5,0,286,214,500
1813,2,31,0,0,1,26,59,6,4,1,14,130,17,291,1,0,292,208,500
1814,4,36,1,1,5,20,40,3,1,0,30,125,23,289,0,0,289,211,500
1815,0,48,3,0,2,28,50,7,0,2,23,105,18,286,3,0,289,165,454
1816,0,119,0,2,1,38,38,3,4,1,14,99,88,407,1,2,410,190,600
1817,0,116,0,1,1,25,47,2,3,5,29,89,74,392,2,0,394,206,600
1818,2,98,1,2,2,37,53,5,10,3,12,83,75,383,2,1,386,214,600
1819,2,116,4,2,4,42,68,7,7,2,16,81,64,415,2,0,417,183,600
1820,3,90,1,1,4,40,44,4,4,2,12,80,82,367,6,0,373,227,600
1826,0,106,0,0,2,29,54,1,1,0,15,77,59,344,3,1,348,152,500
1827,0,79,0,1,1,19,24,1,3,1,13,76,71,289,0,0,289,136,425
1828,0,76,0,1,2,26,37,0,3,3,9,63,54,274,4,1,279,145,424
1829,1,61,0,1,5,31,75,2,4,2,26,57,96,361,4,1,366,234,600
1830,0,51,1,0,5,39,75,2,3,3,29,70,79,357,3,2,362,263,625
1831,1,23,1,0,2,18,39,1,1,0,9,46,85,226,2,0,228,177,405
1832,0,15,0,0,1,15,9,0,1,0,4,128,56,229,4,0,233,117,350
1833,0,12,2,0,0,7,17,1,1,2,14,115,60,231,8,0,239,83,322
1834,1,111,1,0,8,26,83,2,6,3,19,91,82,433,3,1,437,163,600
1835,2,84,0,1,6,34,54,4,4,0,18,87,87,381,3,2,386,214,600
1836,0,105,0,0,3,41,35,6,1,2,24,69,75,361,1,3,365,140,505
1837,0,30,0,0,0,15,56,0,0,2,15,24,65,207,4,0,211,79,290
1838,1,69,0,0,3,39,45,9,1,2,17,73,101,360,3,2,365,167,532
1839,2,81,0,2,5,21,58,3,0,4,14,79,76,345,7,1,353,147,500
1840,2,74,1,1,3,23,62,4,8,1,11,44,74,308,3,0,311,129,440
1841,2,69,3,0,4,24,67,4,1,2,7,43,44,270,0,0,270,127,397
1846,0,22,0,1,5,30,25,4,2,0,20,119,45,273,1,1,275,175,450
1847,2,24,0,1,2,21,38,5,0,1,11,114,53,272,2,0,274,176,450
1848,0,76,0,0,5,28,38,6,2,2,35,80,57,329,6,1,336,164,500
1849,3,78,0,0,0,34,29,6,0,0,36,78,62,326,5,3,334,166,500
1850,2,59,1,0,5,41,41,5,0,1,20,63,53,291,7,3,301,177,478
1851,1,78,2,1,6,43,48,5,3,4,24,74,68,357,4,0,361,239,600
1852,0,63,1,2,3,40,39,5,1,2,23,101,78,358,4,1,363,187,550
1853,1,67,1,1,5,37,36,4,2,0,18,75,73,320,1,2,323,177,500
1854,1,59,1,0,4,29,51,2,6,2,17,88,53,313,5,0,318,182,500
1855,1,62,0,1,2,39,48,1,1,3,15,90,64,327,3,0,330,170,500
1856,1,71,1,0,3,32,42,4,4,1,11,92,70,332,3,0,335,165,500
1857,1,71,0,1,4,31,51,3,2,6,21,105,58,354,1,1,356,177,533
1858,1,64,1,0,2,38,68,1,1,2,18,73,62,331,3,2,336,231,567
1859,1,30,0,1,4,26,48,6,1,0,15,49,47,228,5,1,234,126,360
1860,1,40,0,0,1,20,65,4,1,2,19,53,32,238,1,0,239,111,350
1861,2,66,0,1,9,29,47,0,4,4,25,113,55,355,6,0,361,189,550
1862,0,45,1,0,2,35,27,2,3,1,21,113,69,319,2,1,322,178,500
1863,0,61,0,0,1,35,40,3,0,3,18,107,65,333,2,2,337,163,500
1864,2,62,3,0,3,22,42,1,2,3,17,113,65,335,1,1,337,163,500
1865,2,77,0,0,3,30,25,2,4,3,13,109,50,318,1,0,319,181,500
1866,0,68,1,0,3,41,45,1,2,1,20,107,84,373,1,0,374,139,513
1867,3,33,0,3,4,23,66,3,1,5,17,67,91,316,4,3,323,168,491
1868,0,5,0,0,1,2,14,1,0,1,0,79,78,181,5,1,187,67,254
1869,1,53,5,1,3,17,50,1,1,4,19,121,57,333,5,0,338,162,500
1870,2,31,3,0,4,27,38,4,1,1,12,135,43,301,6,1,308,181,489
1871,1,32,1,0,4,16,21,4,2,0,21,99,36,237,2,1,240,119,359
1872,1,18,1,1,0,13,13,6,0,0,14,84,46,197,6,0,203,97,300
1873,2,33,5,0,3,43,23,3,0,1,26,145,36,320,8,1,329,271,600
1874,1,29,4,0,4,23,35,1,2,3,21,161,39,323,7,1,331,269,600
1875,3,28,3,1,4,18,45,3,2,3,26,155,35,326,12,0,338,262,600
1876,2,20,0,1,3,31,40,0,1,1,15,174,54,342,6,1,349,262,611
1877,1,111,3,1,2,29,63,4,3,2,16,105,77,417,4,0,421,179,600
1878,2,120,2,0,0,38,46,2,6,0,18,79,92,405,0,0,405,195,600
1879,1,118,1,0,4,44,64,2,9,0,19,85,100,447,2,0,449,151,600
1880,2,128,0,4,3,40,62,1,4,3,20,74,72,413,3,1,417,183,600
1881,2,103,2,0,2,34,46,8,6,0,18,78,59,358,4,0,362,164,526
1882,1,102,1,0,4,52,57,1,3,1,18,80,91,411,0,0,411,189,600
1883,1,105,2,1,5,28,55,2,2,4,17,95,81,398,2,1,401,199,600
1884,0,106,1,0,8,49,46,4,5,4,16,70,76,385,5,0,390,178,568
1885,3,87,0,4,2,36,57,1,3,3,16,112,104,428,1,0,429,171,600
1886,2,90,1,2,1,33,56,3,0,4,21,73,67,353,3,1,357,143,500
1887,1,81,1,0,6,27,23,3,2,5,17,92,72,330,6,1,337,164,501
1888,1,84,0,0,4,37,49,3,4,1,14,111,72,380,1,1,382,220,602
1889,2,105,2,1,1,36,47,5,3,3,16,95,78,394,5,1,400,200,600
1890,2,77,2,0,5,30,47,1,5,2,13,103,99,386,5,3,394,206,600
1891,1,81,2,2,5,37,47,3,1,4,16,107,85,391,2,0,393,207,600
1892,1,69,0,2,6,43,45,2,4,1,17,107,88,385,5,0,390,200,590
1893,0,26,0,2,0,17,41,3,0,2,9,83,38,221,1,2,224,146,370
1894,2,14,0,0,2,16,34,3,1,5,9,92,53,231,2,0,233,146,379
1895,0,69,1,3,2,32,53,3,0,2,10,58,48,281,5,3,289,161,450
1896,0,90,0,0,0,29,42,1,1,2,15,47,38,265,5,4,274,126,400
1897,1,79,0,2,1,18,43,0,2,2,14,43,66,271,2,2,275,133,408
1898,2,138,0,2,5,21,72,2,0,2,12,89,55,400,8,1,409,178,587
1899,1,55,6,1,2,32,58,5,1,2,31,87,59,340,5,2,347,253,600
1900,1,47,1,2,2,29,19,2,1,1,19,95,55,274,3,1,278,222,500
1901,1,40,0,0,3,38,27,5,1,3,11,116,59,304,4,0,308,185,493
1902,0,42,2,0,0,23,51,0,1,0,28,32,46,225,2,1,228,122,350
1903,0,53,1,0,0,19,51,1,1,0,15,22,36,199,3,1,203,120,323
1904,0,14,0,0,0,6,47,1,0,2,2,15,22,109,2,1,112,33,145
1905,1,59,2,0,3,25,38,5,2,0,17,81,56,289,4,2,295,130,425
1906,55,1,0,0,0,11,66,3,0,2,10,51,53,252,8,0,260,129,389
1907,2,84,0,0,2,37,53,4,1,3,11,119,60,376,1,2,379,221,600
1908,2,84,1,0,3,37,60,4,4,3,22,115,53,388,4,1,393,207,600
1909,2,53,0,0,4,49,36,3,1,4,12,109,87,360,3,3,366,234,600
1910,2,94,2,0,2,24,41,1,3,2,23,103,68,365,3,5,373,227,600
1911,1,91,1,0,4,24,43,0,1,0,21,100,63,349,0,0,349,201,550
1912,3,80,0,0,4,33,41,1,2,4,24,95,72,359,1,2,362,191,553
1913,0,34,0,0,0,12,44,5,1,2,13,67,89,267,4,2,273,127,400
1914,1,20,0,1,1,15,37,2,0,0,17,59,84,237,4,0,241,136,377
1915,3,67,2,1,3,40,41,2,1,1,17,127,84,389,6,0,395,205,600
1916,5,58,2,1,2,26,37,2,1,3,11,151,76,375,7,1,383,217,600
1917,1,39,1,1,1,31,28,1,2,3,18,122,85,333,7,1,341,159,500
1918,0,50,0,1,3,16,55,0,3,1,18,127,93,367,6,1,374,152,526
1919,0,31,4,1,3,26,93,0,3,2,19,94,70,346,6,3,355,123,478
1920,2,17,0,0,1,17,82,3,1,2,12,122,156,415,3,2,420,162,582
1921,1,57,0,0,1,33,55,1,2,1,7,123,56,337,3,1,341,159,500
1922,2,43,0,0,1,22,70,0,0,3,16,131,36,324,0,1,325,133,458
1923,3,87,2,0,5,35,47,4,2,1,19,110,77,392,6,0,398,202,600
1924,0,101,1,1,4,40,46,5,4,2,14,119,81,418,1,1,420,180,600
1925,3,106,0,2,4,44,52,1,2,1,24,113,68,420,0,3,423,177,600
1926,2,83,1,0,2,42,52,2,3,3,14,105,77,386,3,0,389,211,600
1927,1,75,3,0,3,41,46,2,2,2,16,131,93,415,6,1,422,178,600
1928,2,61,3,1,3,41,33,1,4,3,27,121,65,365,3,2,370,180,550
1929,0,87,0,0,2,23,51,3,5,3,16,82,89,361,4,0,365,191,556
1930,0,104,1,0,8,47,59,6,5,3,11,106,55,405,6,2,413,187,600
1931,0,79,2,2,3,39,49,5,2,2,24,112,75,394,2,1,397,203,600
1932,0,74,1,2,3,50,39,8,0,0,17,112,65,371,1,0,372,228,600
1933,5,61,1,1,5,42,35,4,2,1,16,101,60,334,2,0,336,164,500
1934,3,70,1,0,2,42,28,5,2,1,21,97,45,317,6,1,324,176,500
1935,2,54,2,0,1,38,36,1,5,2,6,92,65,304,2,2,308,176,484
1936,5,55,0,1,4,36,37,3,0,4,24,157,57,383,2,1,386,214,600
1937,2,57,1,0,0,44,32,6,3,1,22,146,51,365,5,1,371,229,600
1938,2,60,0,0,5,36,35,1,2,1,18,161,60,381,2,1,384,216,600
1939,0,62,0,0,3,33,47,4,0,2,17,140,72,380,1,0,381,219,600
1940,4,43,1,0,6,44,40,2,3,2,28,136,59,368,2,1,371,229,600
1941,0,27,0,0,1,25,31,7,4,1,16,160,50,322,3,0,325,175,500
1942,3,58,0,0,0,24,33,6,2,1,16,130,45,318,5,1,324,176,500
1943,0,26,0,1,0,35,36,4,0,0,9,117,61,289,8,2,299,193,492
1944,0,7,0,0,2,2,16,4,0,0,5,40,31,107,1,1,109,191,300
1945,1,8,0,0,3,2,29,1,2,2,3,37,29,117,5,1,123,177,300
1947,1,1,0,0,0,2,34,0,0,0,0,2,14,54,0,1,55,32,87
1948,1,35,1,3,5,23,56,7,1,0,23,126,61,342,4,2,348,262,610
1949,0,44,0,1,1,26,43,3,0,2,17,155,55,347,3,1,351,259,610
1950,1,35,0,0,3,25,39,7,1,6,25,133,64,339,6,1,346,266,612
1951,1,84,1,0,5,36,51,2,1,1,32,115,62,391,4,3,398,202,600
1952,1,70,0,1,3,31,52,0,1,3,33,156,55,406,8,2,416,184,600
1953,2,65,1,2,5,30,45,1,6,3,18,163,59,400,5,0,405,195,600
1954,1,42,2,0,3,25,29,5,3,2,13,122,70,317,2,1,320,180,500
1955,2,63,0,1,7,27,31,6,3,2,16,117,56,331,2,0,333,167,500
1956,2,49,1,1,2,38,25,3,0,4,19,97,44,285,2,3,290,167,457
1957,1,60,1,1,0,28,40,2,1,0,19,98,69,320,4,0,324,176,500
1958,2,77,1,1,3,36,40,0,3,2,11,90,46,312,1,0,313,191,504
1959,2,7,0,0,0,2,25,0,1,2,0,38,6,83,6,0,89,10,99
1960,1,49,0,0,2,23,35,1,4,0,19,58,84,276,5,1,282,168,450
1961,0,51,1,2,2,14,42,2,0,3,27,81,70,295,1,0,296,154,450
1962,1,60,0,0,3,11,31,0,4,1,11,70,104,296,3,0,299,132,431
1963,0,48,0,0,7,7,43,5,0,3,13,9,79,214,1,0,215,91,306
1964,0,52,1,0,1,16,52,1,2,1,8,21,125,280,1,0,281,119,400
1965,0,43,0,1,0,23,93,4,3,2,16,23,99,307,0,2,309,118,427
1966,1,42,1,0,0,13,28,2,1,1,12,10,73,184,2,0,186,99,285
1967,0,40,1,0,1,8,36,0,2,0,24,27,24,163,2,0,165,66,231
1968,1,61,0,0,3,23,45,3,1,0,16,64,78,295,5,1,301,149,450
1969,3,30,1,0,4,18,64,0,0,2,20,65,60,267,4,0,271,157,428
1970,2,26,1,1,1,11,19,0,0,4,9,19,102,195,4,1,200,74,274
1971,1,21,1,0,3,2,24,1,1,0,7,12,100,173,3,0,176,58,234
1972,2,33,0,0,1,3,22,1,1,1,8,12,36,120,1,1,122,30,152
1973,0,10,0,1,0,7,10,0,0,2,4,4,22,60,1,1,62,26,88
1974,0,10,0,2,2,12,16,3,2,5,11,14,82,159,2,3,164,77,241
1975,0,27,1,0,4,10,29,2,0,1,35,19,39,167,3,0,170,78,248
1976,1,23,0,1,2,25,40,1,0,1,6,106,71,277,1,2,280,170,450
1977,0,31,0,0,5,19,32,2,4,3,4,111,81,292,1,0,293,157,450
1978,2,18,0,0,0,16,42,4,2,0,7,106,86,283,3,0,286,129,415
1979,0,21,0,0,5,50,78,0,1,4,13,78,140,390,5,2,397,194,591
1980,2,14,0,1,1,37,38,0,0,4,6,64,156,323,8,0,331,161,492
1981,1,24,1,0,0,27,72,0,0,2,18,96,69,310,1,1,312,146,458
1982,1,24,1,1,3,17,49,1,1,0,8,128,41,275,3,0,278,122,400
1983,0,14,1,0,5,13,21,1,0,0,12,106,50,223,3,1,227,125,352
1984,1,25,2,1,1,48,44,2,2,2,15,121,47,311,2,2,315,285,600
1985,2,20,3,0,3,29,49,5,1,5,13,144,80,354,6,1,361,223,584
1986,1,5,1,0,0,10,31,1,0,2,3,84,47,185,3,0,188,162,350
1987,1,5,0,0,1,7,35,1,1,1,2,76,28,158,2,0,160,154,314
1988,1,8,0,0,0,9,39,3,2,0,20,80,62,224,1,0,225,125,350
1989,0,9,0,2,3,8,31,2,0,0,6,103,50,214,1,0,215,121,336
1990,1,2,1,1,3,4,44,1,5,0,10,35,18,125,3,1,129,105,234
1991,0,29,0,0,1,23,76,1,0,4,17,62,35,248,3,0,251,99,350
1992,1,17,2,0,1,11,71,3,2,3,15,64,42,232,1,1,234,107,341
1993,2,16,1,0,0,16,64,1,2,2,8,91,81,284,4,1,289,161,450
1994,2,45,0,1,3,18,55,4,1,2,9,85,92,317,1,1,319,131,450
1995,0,34,0,2,1,21,49,6,2,0,10,114,71,310,1,0,311,133,444
1996,0,34,2,2,4,25,43,3,3,2,27,127,70,342,5,1,348,202,550
1997,1,21,0,1,2,25,45,3,4,1,17,188,50,358,2,3,363,183,546
1998,0,23,1,1,0,7,64,1,0,1,3,43,86,230,1,0,231,127,358
1999,1,20,0,0,0,6,62,1,0,0,3,21,32,146,0,1,147,64,211
2000,1,11,1,0,0,4,30,1,0,0,3,18,73,142,1,1,144,31,175
2001,1,18,1,0,0,17,44,0,1,0,7,105,108,302,3,0,305,145,450
2002,2,30,2,1,0,16,40,2,0,0,8,158,56,315,6,1,322,128,450
2003,1,22,1,0,1,18,33,2,2,2,9,124,56,271,6,0,277,147,424
2004,0,9,3,2,0,6,15,0,1,1,4,30,58,129,4,2,135,84,219
2005,0,30,0,0,0,31,54,1,0,1,12,89,34,252,6,0,258,137,395
2006,1,26,1,1,0,36,46,1,3,2,16,77,76,286,1,1,288,212,500
2007,0,25,0,0,1,27,41,2,2,1,14,64,76,253,3,0,256,194,450
2008,0,21,1,1,3,34,33,0,0,2,15,75,75,260,1,0,261,189,450
2009,0,25,0,1,4,38,72,2,0,8,41,64,90,345,8,4,357,199,556
2010,0,16,0,1,1,12,38,3,2,5,11,26,56,171,5,1,177,117,294
2011,2,4,0,0,0,4,10,0,1,0,5,15,11,52,3,0,55,43,98
2012,0,19,3,0,1,5,39,1,0,1,26,30,61,186,4,0,190,90,280
2013,2,30,2,1,4,29,70,7,0,2,12,135,28,322,5,0,327,173,500
2014,0,32,3,1,2,16,71,2,2,1,16,100,40,286,4,0,290,169,459
2015,0,10,0,0,1,3,17,1,0,0,10,41,47,130,1,1,132,86,218
2016,1,10,0,3,0,6,50,2,0,0,2,40,37,151,7,0,158,107,265
2017,0,2,0,0,0,1,11,2,0,0,1,10,48,75,2,0,77,49,126
2018,2,20,0,0,1,9,32,0,0,0,5,20,29,118,2,0,120,76,196
2019,1,30,0,5,0,13,76,3,0,1,10,163,105,407,3,3,413,187,600
2020,0,17,0,0,1,19,71,2,1,3,14,137,87,352,6,1,359,191,550
2021,0,11,2,0,0,17,54,0,0,0,11,125,52,272,12,0,284,216,500
2022,0,10,0,0,2,16,58,2,1,2,16,103,79,289,3,1,293,207,500
2023,0,25,0,0,1,21,55,1,0,1,13,131,80,328,5,0,333,188,521
2024,2,54,0,2,1,22,51,6,7,4,18,42,79,288,5,0,293,209,502
2025,2,17,1,1,2,14,59,0,3,5,16,62,39,221,6,2,229,121,350
2026,2,29,2,0,3,18,70,0,0,4,19,58,42,247,5,5,257,117,374
2027,3,42,1,1,2,28,78,4,1,0,17,99,86,362,7,0,369,231,600
2028,0,35,1,1,1,26,78,3,2,3,18,116,64,348,9,2,359,191,550
2029,3,24,4,3,2,19,59,3,2,1,21,110,77,328,2,4,334,188,522
2030,1,39,0,0,0,26,40,3,4,2,12,67,70,264,6,0,270,130,400
2031,0,41,1,0,1,12,30,2,6,3,22,65,67,250,1,1,252,147,399
2032,1,44,0,1,1,18,56,1,1,2,44,123,44,336,9,1,346,204,550
2033,1,33,1,1,2,17,60,1,0,0,30,122,46,314,5,2,321,232,553
2034,2,59,1,0,2,28,60,4,2,2,28,75,92,355,5,2,362,230,592
2035,0,10,1,2,0,11,42,0,0,0,9,28,96,199,1,1,201,146,347
2036,2,33,1,0,0,24,29,3,1,1,15,38,28,175,4,0,179,147,326
2037,1,19,0,0,1,14,21,1,0,0,12,53,46,168,6,0,174,152,326
2038,0,4,0,0,0,5,6,1,0,0,1,6,10,33,0,1,34,56,90
2039,0,13,0,2,3,17,43,0,1,1,14,47,82,223,3,0,226,79,305
2040,0,19,1,0,2,11,95,3,1,3,10,47,72,264,1,1,266,174,440
2041,0,29,4,1,4,11,100,1,2,5,6,75,44,282,3,1,286,154,440
2042,0,21,0,0,1,3,50,0,0,0,2,8,94,179,2,1,182,110,292
2043,0,8,0,0,1,1,7,0,0,1,3,41,28,90,2,1,93,41,134
2044,0,4,0,0,0,3,30,0,0,1,2,15,40,95,2,0,97,63,160
2045,3,26,3,4,0,26,88,3,1,3,25,68,80,330,2,0,332,164,496
2046,0,9,1,0,0,9,60,0,0,0,20,15,15,129,1,1,131,111,242
2047,0,8,0,0,1,7,38,1,0,2,4,37,34,132,2,1,135,60,195
2048,3,53,1,0,2,23,53,3,2,1,9,103,99,352,4,0,356,144,500
2049,1,35,0,0,1,25,68,0,2,1,15,62,120,330,5,1,336,164,500
2050,0,39,0,0,1,18,58,4,2,1,17,95,72,307,2,1,310,209,519
2051,0,4,0,0,0,16,62,0,1,0,3,6,10,102,0,1,103,58,161
2052,1,18,1,1,0,13,45,2,0,0,7,39,44,171,5,0,176,84,260
2053,0,15,0,0,0,6,67,0,0,2,6,17,77,190,1,0,191,58,249
2054,1,25,1,0,1,17,23,1,0,0,9,6,28,112,2,1,115,50,165
2055,0,34,3,0,3,16,37,2,0,1,13,43,41,193,3,0,196,120,316
2056,0,21,0,0,0,8,11,0,1,2,10,16,65,134,0,2,136,44,180
2057,0,10,0,0,1,4,54,1,0,1,11,16,62,160,0,1,161,56,217
2058,2,55,2,0,7,22,84,6,3,2,51,52,86,372,1,1,374,162,536
2059,0,4,0,0,1,6,11,0,0,3,8,10,30,73,0,3,76,17,93
2060,0,5,0,0,0,2,5,0,0,0,0,7,15,34,0,0,34,10,44
2061,0,12,0,0,0,25,52,0,0,0,21,59,19,188,5,6,199,108,307
2062,2,19,0,0,0,8,25,3,0,0,5,41,27,130,4,0,134,91,225
2063,0,13,2,0,4,10,96,1,1,2,5,56,79,269,2,2,273,105,378
2064,0,14,1,0,2,10,30,2,1,1,10,55,29,155,5,3,163,131,294
2065,2,26,2,0,1,18,63,1,2,2,27,83,56,283,3,3,289,186,475
2066,3,23,0,0,3,28,60,5,0,5,30,84,61,302,3,0,305,173,478
2067,2,119,0,0,2,45,64,4,1,3,31,32,103,406,0,2,408,192,600
2068,0,85,0,0,3,30,90,1,2,3,39,33,73,359,2,3,364,236,600
2069,1,98,0,2,3,21,74,4,1,1,13,36,65,319,4,1,324,226,550
2070,2,91,1,2,4,25,57,0,1,3,26,21,77,310,4,1,315,185,500
2071,0,89,1,1,2,22,71,0,1,1,25,26,69,308,5,1,314,207,521
2072,0,93,2,0,2,35,61,10,0,2,19,22,52,298,1,1,300,184,484
2073,0,41,1,0,4,9,48,0,0,0,15,64,43,225,2,0,227,143,370
2074,1,32,0,0,3,8,45,3,2,0,22,51,59,226,0,1,227,137,364
2075,2,51,0,0,10,5,52,1,0,2,7,18,25,173,3,1,177,89,266
2076,1,7,0,0,0,0,20,1,0,0,4,17,5,55,0,0,55,96,151
2077,0,69,1,0,2,15,58,1,1,1,18,20,33,219,3,2,224,126,350
2078,0,72,1,0,0,20,39,4,0,4,16,20,39,215,2,0,217,127,344
2079,0,30,0,0,0,16,78,1,1,0,16,24,54,220,3,1,224,128,352
2080,1,28,0,0,0,2,29,0,1,0,12,13,63,149,1,3,153,99,252
2081,0,7,0,0,0,0,25,0,0,0,1,6,35,74,5,1,80,21,101
2082,0,57,1,2,1,24,88,3,2,4,20,48,42,292,1,1,294,156,450
2083,1,68,0,1,0,10,66,4,3,4,14,44,32,247,0,0,247,166,413
2084,0,8,0,0,1,5,40,2,1,1,30,13,13,114,1,0,115,76,191
2085,0,36,0,1,1,11,31,3,0,3,5,27,7,125,1,0,126,40,166
2086,2,103,0,2,2,24,40,4,6,7,25,27,49,291,8,1,300,105,405
2087,2,70,3,0,2,22,45,2,6,8,30,26,57,273,4,2,279,128,407
2088,2,39,0,0,1,16,60,4,1,3,38,37,23,224,6,2,232,100,332
2089,1,16,2,1,0,9,20,2,1,0,13,19,22,106,0,0,106,54,160
2090,0,16,0,0,0,5,12,0,1,0,2,3,7,46,0,1,47,20,67
2091,2,107,2,0,6,27,88,5,2,2,23,56,46,366,5,0,371,169,540
2092,0,47,1,0,2,23,43,3,5,7,9,22,23,185,1,2,188,86,274
2093,0,105,1,1,2,32,102,3,3,3,18,77,92,439,2,0,441,159,600
2094,2,124,0,0,2,40,90,2,5,0,16,60,95,436,4,1,441,159,600
2095,0,119,2,1,5,43,92,0,5,0,9,57,85,418,0,0,418,182,600
2096,1,100,1,1,3,38,102,6,2,1,7,63,106,431,5,0,436,164,600
2097,1,94,1,1,2,36,117,3,3,0,9,53,91,411,2,0,413,187,600
2098,0,91,1,0,4,27,112,4,3,1,15,44,117,419,1,0,420,180,600
2099,1,106,3,2,5,32,97,1,1,1,21,52,94,416,3,1,420,180,600
2100,1,116,1,1,1,34,88,3,6,1,10,71,104,437,1,0,438,162,600
2101,2,114,1,0,3,44,87,2,3,3,10,56,108,433,0,0,433,167,600
2102,0,110,0,1,3,35,103,2,4,1,13,56,85,413,1,1,415,185,600
2103,0,104,0,0,1,37,96,5,3,0,15,43,89,393,2,0,395,155,550
2104,1,112,2,1,3,36,80,4,6,0,12,50,88,395,1,0,396,142,538
2105,0,107,0,0,2,51,83,4,0,1,16,101,79,444,3,0,447,153,600
2106,0,107,3,0,7,38,84,4,5,4,15,114,73,454,2,1,457,143,600
2107,2,101,1,0,3,34,61,7,3,3,15,103,71,404,3,0,407,193,600
2108,0,112,0,0,0,33,83,2,2,0,20,121,55,428,6,1,435,165,600
2109,1,114,1,0,4,42,77,5,0,0,15,88,74,421,4,2,427,173,600
2110,0,96,0,1,4,31,101,2,4,2,27,86,72,426,1,0,427,173,600
2111,0,102,0,4,2,27,103,8,2,1,20,78,66,413,0,1,414,186,600
2112,0,125,2,1,5,29,70,6,1,3,21,95,80,438,4,1,443,157,600
2113,4,105,0,0,5,43,81,6,1,7,14,90,69,425,6,1,432,168,600
2114,4,128,1,0,0,40,67,0,2,1,27,110,62,442,2,0,444,156,600
2115,0,131,3,0,4,36,72,6,2,1,12,105,58,430,1,0,431,169,600
2116,2,125,0,0,1,44,77,2,3,1,24,86,74,439,3,0,442,158,600
2117,0,118,0,1,2,39,74,2,2,2,12,71,57,380,2,0,382,118,500
2118,0,107,1,0,1,32,77,1,2,5,18,64,62,370,0,1,371,129,500
2119,0,114,0,0,7,40,60,6,0,5,17,74,59,382,1,0,383,117,500
2120,0,88,0,1,2,33,56,3,2,6,13,77,57,338,3,1,342,158,500
2121,2,120,1,3,7,25,83,3,7,2,12,57,56,378,1,0,379,144,523
2122,2,126,0,2,2,34,58,4,4,3,14,75,56,380,1,1,382,141,523
2123,1,113,0,0,1,41,61,8,8,1,22,92,69,417,5,0,422,178,600
2124,1,116,0,0,2,28,66,1,5,2,22,102,52,397,1,1,399,201,600
2125,4,90,1,0,5,31,56,1,6,3,33,118,62,410,0,0,410,190,600
2126,0,99,0,1,6,31,52,7,3,4,24,104,55,386,3,0,389,211,600
2127,3,100,1,1,5,32,57,2,7,3,14,133,48,406,2,1,409,191,600
2128,3,94,0,0,3,32,60,3,1,2,22,103,59,382,1,1,384,216,600
2129,1,91,0,0,3,35,61,2,6,4,25,122,67,417,4,0,421,179,600
2130,4,104,2,1,2,42,54,5,4,0,18,105,49,390,1,0,391,209,600
2131,1,90,1,0,3,27,71,1,3,3,21,129,38,388,2,0,390,210,600
2132,2,104,1,0,2,22,61,10,3,1,14,100,68,388,2,0,390,210,600
2133,3,93,2,1,1,32,58,1,1,5,21,126,59,403,4,0,407,193,600
2134,2,73,1,1,6,27,50,2,5,7,25,99,48,346,1,0,347,153,500
2135,1,72,2,0,2,24,45,3,2,1,19,99,63,333,2,0,335,165,500
2136,3,89,0,0,0,22,46,1,3,1,18,111,56,350,4,0,354,146,500
2137,2,99,1,0,2,42,47,7,3,0,15,118,51,387,0,0,387,163,550
2138,0,88,1,1,1,18,57,5,8,2,20,103,58,362,2,4,368,162,530
2139,1,74,2,0,3,39,67,3,4,4,24,130,48,399,3,7,409,191,600
2140,1,56,1,2,3,34,57,6,1,2,28,130,39,360,5,1,366,234,600
2141,2,72,0,0,1,56,57,5,1,2,20,118,29,363,3,0,366,234,600
2142,1,74,3,0,2,42,68,2,1,0,16,145,35,389,1,0,390,210,600
2143,3,83,4,0,2,48,57,4,4,3,14,118,38,378,2,1,381,219,600
2144,3,75,2,1,2,39,65,6,3,5,25,117,40,383,4,0,387,213,600
2145,3,90,3,1,2,31,58,6,2,4,17,121,35,373,2,0,375,225,600
2146,1,58,4,2,2,38,56,3,1,1,21,132,38,357,6,0,363,195,558
2147,0,8,0,2,0,6,28,1,0,2,9,2,13,71,1,1,73,100,173
2148,1,108,0,2,5,47,70,3,5,4,15,119,55,434,2,0,436,164,600
2149,1,91,1,0,0,24,84,2,2,0,18,90,72,385,3,0,388,112,500
2150,2,111,2,0,5,38,81,0,2,1,16,78,61,397,3,0,400,162,562
2151,0,112,2,1,6,44,115,3,5,0,16,86,69,459,1,1,461,139,600
2152,2,109,2,0,4,40,100,3,2,0,14,88,74,438,2,0,440,160,600
2153,2,110,2,0,5,43,97,4,4,2,11,58,66,404,3,0,407,137,544
2154,0,114,2,1,4,55,79,3,6,3,18,80,43,408,1,0,409,191,600
2155,1,94,0,3,9,39,80,3,5,0,22,86,59,401,1,1,403,197,600
2156,1,86,2,2,4,50,82,7,3,2,22,99,57,417,2,1,420,179,599
2157,1,100,0,0,2,48,76,6,4,1,13,88,45,384,4,0,388,212,600
2158,3,98,0,0,2,54,72,3,1,1,20,77,61,392,1,0,393,207,600
2159,0,106,0,0,0,42,57,3,2,0,18,94,53,375,1,0,376,224,600
2160,0,112,0,0,0,38,73,4,1,1,25,106,58,418,2,1,421,179,600
2161,2,117,0,0,1,33,84,5,6,2,19,80,75,424,4,1,429,171,600
2162,0,89,0,2,4,38,83,2,2,2,19,85,60,386,2,0,388,211,599
2163,3,92,0,1,4,26,59,5,5,2,18,149,33,397,7,1,405,195,600
2164,2,99,1,1,0,40,64,2,2,3,14,104,47,379,4,2,385,215,600
2165,3,54,0,2,4,45,68,4,0,1,28,117,47,373,3,0,376,224,600
2166,2,72,1,0,2,44,55,2,1,4,14,137,46,380,2,0,382,218,600
2167,2,66,4,1,3,28,64,1,5,0,11,115,45,345,1,0,346,254,600
2169,3,76,0,1,2,32,53,1,6,2,19,138,39,372,4,0,376,224,600
2170,2,80,3,1,3,43,66,5,2,5,15,95,54,374,7,0,381,219,600
2171,1,76,2,1,1,41,40,1,4,4,16,124,54,365,1,1,367,233,600
2172,1,75,0,1,2,52,68,4,3,4,13,130,29,382,4,0,386,214,600
2173,4,77,2,2,2,29,48,4,5,1,21,126,42,363,2,1,366,234,600
2174,2,94,0,0,1,50,57,5,4,2,32,96,57,400,3,0,403,197,600
2175,1,78,1,0,3,37,53,4,6,2,20,117,54,376,2,0,378,222,600
2176,0,78,0,0,2,46,45,6,1,0,14,134,57,383,1,0,384,216,600
2177,1,66,0,0,3,27,44,4,3,4,11,101,40,304,2,0,306,189,495
2178,0,77,0,2,1,29,72,2,2,4,12,84,35,320,5,1,326,228,554
2179,2,118,2,0,3,31,51,3,4,2,19,98,68,401,5,2,408,192,600
2180,1,101,1,2,1,43,71,4,2,1,21,104,71,423,1,0,424,176,600
2181,1,91,1,0,2,26,43,1,4,1,16,134,63,383,2,0,385,215,600
2182,0,120,1,0,1,32,64,6,3,2,24,108,59,420,4,0,424,176,600
2183,3,101,2,0,1,31,56,1,4,0,15,136,73,423,3,0,426,174,600
2184,1,104,1,0,0,38,50,3,7,2,12,109,78,405,3,0,408,192,600
2185,1,103,1,1,5,39,28,2,1,2,11,79,55,328,2,0,330,170,500
2186,0,94,1,2,1,22,66,1,4,2,8,97,51,349,1,0,350,150,500
2187,1,115,1,0,2,27,50,2,3,1,17,76,50,345,2,3,350,150,500
2188,0,112,1,1,2,22,55,1,6,0,11,72,60,343,3,3,349,151,500
2189,1,75,1,3,2,25,47,2,3,3,15,105,68,350,0,0,350,150,500
2190,0,115,2,2,3,18,48,8,4,1,20,110,78,409,0,0,409,163,572
2191,1,57,3,0,0,25,43,1,1,2,5,123,43,304,5,0,309,191,500
2192,2,50,1,0,2,44,46,3,3,2,14,112,29,308,0,2,310,190,500
2193,1,33,2,2,1,42,57,4,3,3,9,131,30,318,3,1,322,239,561
2194,2,83,3,0,5,46,59,5,2,3,12,128,65,413,4,1,418,182,600
2195,3,94,2,0,1,27,68,2,12,4,13,128,72,426,3,0,429,171,600
2196,1,90,1,1,1,35,68,0,8,4,23,115,66,413,3,0,416,184,600
2197,2,92,2,1,2,27,59,3,4,1,18,125,66,402,9,0,411,189,600
2198,3,96,2,0,2,31,57,3,4,1,17,135,54,405,3,2,410,190,600
2199,1,69,3,1,2,39,58,1,3,1,12,112,40,342,1,1,344,156,500
2200,1,70,0,1,3,27,56,0,1,0,11,118,37,325,1,0,326,186,512
2201,1,125,0,1,2,35,65,5,4,1,19,109,64,431,3,2,436,164,600
2202,2,130,4,3,4,36,69,1,5,1,15,102,83,455,3,0,458,142,600
2203,1,123,0,4,4,40,61,4,2,2,23,86,59,409,3,2,414,186,600
2204,1,138,1,0,0,40,77,0,3,1,19,107,75,462,0,0,462,138,600
2205,2,104,1,0,3,40,61,6,6,3,17,135,57,435,2,1,438,162,600
2206,4,149,0,1,1,31,53,3,0,0,14,89,71,416,6,0,422,178,600
2207,1,99,2,0,1,38,70,3,3,1,12,117,64,411,3,0,414,186,600
2208,2,110,3,0,2,37,82,1,4,1,16,98,63,419,3,2,424,176,600
2209,1,130,2,0,3,31,65,2,4,3,23,99,55,418,2,1,421,179,600
2210,0,118,0,3,1,31,63,1,3,0,21,106,65,412,2,0,414,186,600
2211,0,112,1,0,1,36,70,2,7,1,18,101,57,406,5,0,411,189,600
2212,0,127,0,0,5,38,68,4,7,0,12,107,76,444,4,0,448,152,600
2213,2,104,4,2,4,47,71,3,3,3,14,110,63,430,2,1,433,167,600
2214,0,133,1,2,2,28,65,2,1,2,21,104,73,434,4,0,438,162,600
2215,2,115,0,1,2,30,58,3,3,2,21,117,61,415,1,1,417,183,600
2216,2,102,1,0,1,31,63,4,2,3,19,104,70,402,3,0,405,195,600
2217,0,105,1,1,5,33,53,4,2,4,21,122,54,405,4,0,409,191,600
2218,2,121,1,3,1,25,94,2,4,2,20,97,62,434,2,1,437,163,600
2219,2,99,1,2,3,37,61,6,3,0,20,99,51,384,0,1,385,165,550
2220,2,122,0,0,5,27,36,5,2,1,13,117,48,378,2,0,380,168,548
2221,1,95,1,0,5,26,86,4,4,0,22,94,78,416,4,1,421,179,600
2222,2,91,1,1,4,34,75,4,2,3,12,70,30,329,6,0,335,165,500
2223,0,88,3,1,2,21,53,4,2,1,26,63,52,316,2,0,318,182,500
2224,1,82,0,0,1,33,76,1,3,1,17,61,71,347,5,0,352,148,500
2225,2,86,0,0,6,26,46,5,5,1,27,72,61,337,1,0,338,170,508
2226,1,62,1,0,3,16,49,2,1,1,9,95,19,259,2,2,263,187,450
2227,2,80,0,0,3,18,45,2,2,2,16,87,26,283,3,1,287,160,447
2228,1,67,0,0,0,16,62,4,2,1,10,90,45,298,3,1,302,148,450
2229,3,73,0,0,4,13,57,7,1,2,5,104,40,309,3,0,312,138,450
2230,2,61,1,1,1,21,47,5,2,2,17,106,35,301,1,0,302,146,448
2231,0,101,1,2,4,34,93,3,1,1,21,102,75,438,2,1,441,159,600
2232,1,103,1,0,3,47,75,5,3,1,19,87,75,420,6,0,426,174,600
2233,1,76,1,0,0,41,68,2,1,2,24,70,59,345,0,1,346,154,500
2234,0,88,0,1,2,25,91,4,1,0,22,89,43,366,4,0,370,130,500
2235,1,57,0,1,2,31,63,2,4,1,12,65,66,305,3,1,309,139,448
2236,1,88,2,1,3,20,58,7,2,0,22,146,63,413,8,0,421,179,600
2237,0,93,1,3,2,23,74,7,2,4,24,127,60,420,2,1,423,177,600
2238,0,84,4,2,2,32,50,4,2,2,24,145,34,385,2,0,387,213,600
2239,0,87,0,0,0,31,61,3,1,0,24,120,40,367,7,0,374,226,600
2240,2,78,0,1,2,30,62,3,3,2,29,148,36,396,4,0,400,200,600
2241,3,76,0,1,2,37,52,5,7,3,18,161,53,418,5,0,423,177,600
2242,0,83,0,1,0,27,60,2,1,3,30,122,58,387,2,0,389,211,600
2243,2,62,1,0,2,33,56,4,7,3,31,129,56,386,3,2,391,209,600
2244,0,79,2,2,3,40,60,4,2,1,27,134,47,401,6,1,408,192,600
2245,3,84,0,0,2,32,48,4,3,6,36,149,69,436,4,0,440,160,600
2246,3,72,2,1,0,32,70,7,2,2,29,134,50,404,1,1,406,194,600
2247,0,85,1,0,1,31,59,5,5,1,26,128,53,395,2,0,397,203,600
2248,3,73,4,0,0,28,55,5,1,4,21,158,46,398,3,1,402,198,600
2249,3,83,3,0,1,31,73,5,4,3,19,117,52,394,4,0,398,202,600
2250,1,85,0,1,1,24,55,4,3,3,25,132,53,387,0,0,387,173,560
2251,0,111,1,0,0,29,84,2,3,1,19,114,43,407,3,0,410,190,600
2252,1,83,2,2,1,26,70,4,1,2,28,100,49,369,7,0,376,224,600
2253,0,100,0,0,3,39,58,3,1,1,18,125,46,394,6,0,400,200,600
2254,0,75,1,1,2,38,60,1,3,2,19,145,44,391,5,1,397,203,600
2255,3,74,2,1,1,24,90,3,3,1,22,116,43,383,5,1,389,211,600
2256,0,96,0,2,5,36,63,3,2,2,22,114,50,395,3,1,399,201,600
2257,1,78,0,0,2,18,58,1,0,2,30,90,40,320,2,1,323,177,500
2258,1,68,1,1,1,26,56,7,0,2,31,105,40,339,6,0,345,155,500
2259,0,81,2,0,4,28,51,3,6,2,16,93,55,341,3,0,344,181,525
2260,1,90,0,0,3,30,59,3,0,2,19,85,54,346,3,1,350,175,525
2261,3,74,2,1,1,29,57,2,4,2,24,107,58,364,0,0,364,165,529
2262,3,73,2,0,0,27,95,4,3,2,19,135,37,400,5,0,405,195,600
2263,1,47,2,0,3,25,52,5,0,2,18,152,37,344,6,1,351,249,600
2264,2,58,1,1,2,29,73,2,3,4,24,129,38,366,4,0,370,230,600
2265,1,57,0,0,4,30,57,2,3,0,20,159,26,359,5,1,365,235,600
2266,2,69,2,2,3,23,68,4,5,2,20,123,47,370,4,0,374,226,600
2267,2,76,3,2,1,27,86,8,4,2,14,127,39,391,6,0,397,203,600
2268,0,77,1,0,2,26,56,3,3,2,14,118,42,344,7,0,351,183,534
2269,1,83,1,1,3,26,86,6,3,0,23,76,86,395,5,1,401,199,600
2270,1,74,4,0,3,34,96,2,4,1,30,89,76,414,4,0,418,182,600
2271,0,87,1,0,2,37,81,5,4,1,24,107,76,425,4,0,429,171,600
2272,2,113,2,0,2,41,66,3,8,2,16,73,89,417,3,0,420,180,600
2273,0,66,4,0,1,21,86,1,4,1,21,72,62,339,3,1,343,157,500
2274,1,68,0,1,3,35,64,1,4,1,28,83,60,349,1,0,350,150,500
2275,1,75,1,1,1,23,71,4,3,3,20,69,79,351,1,0,352,148,500
2276,2,90,0,1,2,24,61,2,3,2,17,91,62,357,3,0,360,140,500
2277,0,98,4,1,1,37,88,6,2,4,23,81,54,399,3,0,402,147,549
2278,1,88,2,1,2,43,69,3,5,0,15,114,72,415,2,0,417,183,600
2279,2,63,0,0,1,28,61,5,1,2,19,85,63,330,7,0,337,163,500
2280,0,77,0,0,3,34,58,4,4,3,22,68,42,315,3,0,318,182,500
2281,2,70,3,2,1,28,63,4,2,2,17,84,44,322,3,0,325,189,514
2282,0,65,1,3,2,40,133,3,1,0,13,47,45,353,2,1,356,94,450
2283,0,59,0,1,3,34,75,1,4,1,19,54,74,325,2,0,327,123,450
2284,1,41,2,2,0,38,46,3,4,2,16,71,70,296,3,0,299,110,409
2285,1,64,1,2,3,49,89,6,3,0,26,72,116,432,8,0,440,160,600
2286,2,81,2,0,0,54,115,4,2,3,14,61,121,459,1,0,460,140,600
2287,1,57,7,1,3,50,96,1,0,1,22,54,110,403,7,0,410,133,543
2288,2,49,1,1,0,25,47,9,0,2,19,136,28,319,3,0,322,178,500
2289,1,42,0,1,2,42,32,7,3,3,13,153,37,336,4,1,341,159,500
2290,1,43,0,1,0,25,39,4,0,4,16,147,38,318,3,1,322,178,500
2291,2,40,3,1,0,31,40,9,2,2,36,146,27,339,4,0,343,207,550
2292,2,39,2,0,0,26,44,6,5,4,17,153,27,325,4,0,329,195,524
2293,1,73,2,0,1,23,36,4,2,3,17,184,42,388,5,1,394,206,600
2294,2,63,4,0,0,28,42,5,4,0,26,163,47,384,4,0,388,212,600
2295,2,69,1,0,3,35,45,2,2,4,26,163,43,395,3,0,398,202,600
2296,0,48,2,0,0,26,28,1,2,1,21,159,34,322,3,0,325,199,524
2297,1,68,0,0,1,34,56,2,0,1,15,96,54,328,6,0,334,166,500
2299,1,55,2,0,4,40,43,3,2,1,15,100,45,311,0,1,312,188,500
2300,2,51,1,1,1,27,41,2,0,0,18,75,39,258,3,1,262,166,428
2301,4,89,4,1,2,40,72,8,1,2,24,91,62,400,3,1,404,196,600
2302,2,79,1,0,3,40,54,5,1,4,23,110,45,367,1,1,369,231,600
2303,3,66,1,2,2,35,73,5,1,3,11,67,47,316,7,1,324,176,500
2304,1,65,1,0,1,35,47,6,4,1,18,77,52,308,2,2,312,188,500
2305,0,64,1,1,2,28,51,8,1,2,19,83,40,300,1,0,301,199,500
2306,1,56,0,0,2,35,58,1,1,1,21,102,52,330,5,1,336,221,557
2307,0,33,1,1,0,19,42,6,4,1,20,161,14,302,5,0,307,193,500
2308,1,43,3,0,2,22,39,7,4,1,22,139,33,316,6,1,323,177,500
2309,2,31,0,0,1,12,51,7,3,0,14,141,24,286,5,1,292,146,438
2310,1,119,0,0,4,31,80,3,7,4,17,95,66,427,3,1,431,169,600
2311,1,99,5,1,1,44,86,2,5,1,10,70,91,416,1,1,418,182,600
2312,1,99,2,1,2,22,74,3,4,0,9,62,75,354,0,0,354,146,500
2313,1,111,0,2,1,36,58,5,3,1,7,80,96,401,5,0,406,151,557
2314,2,78,3,0,2,31,69,2,2,3,32,144,55,423,2,0,425,175,600
2315,3,59,4,0,1,35,56,2,2,2,25,139,41,369,7,0,376,174,550
2316,1,55,0,0,3,25,49,3,3,4,25,123,41,332,2,0,334,190,524
2317,0,43,1,0,2,15,37,3,0,0,11,35,36,183,1,1,185,129,314
2318,0,68,1,0,0,38,42,3,11,1,20,98,54,336,0,0,336,164,500
2319,4,58,0,1,1,44,49,2,5,2,17,113,67,363,2,0,365,147,512
2321,1,71,1,1,3,15,62,5,2,4,11,84,35,295,2,1,298,132,430
2322,2,70,1,0,2,14,93,2,1,0,9,59,40,293,3,0,296,130,426
2323,0,67,2,1,2,22,82,1,0,3,29,113,28,350,0,0,350,150,500
2324,2,71,1,0,2,22,67,0,6,2,24,108,51,356,0,0,356,177,533
2325,2,46,1,0,2,28,54,6,4,1,13,126,21,304,2,1,307,193,500
2326,0,54,2,2,1,44,61,6,6,0,12,109,22,319,3,0,322,216,538
2327,0,42,2,1,5,15,47,3,2,0,18,101,29,265,5,0,270,130,400
2328,0,37,0,0,1,18,29,1,1,3,23,96,24,233,6,0,239,164,403
2329,1,33,0,0,2,16,46,2,0,0,14,141,19,274,2,1,277,123,400
2330,0,46,1,0,1,14,28,1,1,0,20,105,30,247,3,2,252,115,367
2331,1,57,1,0,1,31,50,8,15,1,19,138,51,373,7,0,380,189,569
2332,1,83,1,0,3,34,86,1,3,3,27,83,70,395,6,0,401,199,600
2333,3,94,3,3,3,35,93,3,5,0,28,82,68,420,2,0,422,178,600
2335,0,100,2,1,2,36,74,4,2,3,20,72,68,384,2,0,386,214,600
2336,1,95,2,0,3,37,99,9,4,1,26,89,70,436,4,0,440,160,600
2337,1,62,1,1,0,31,74,1,3,0,29,87,99,389,3,0,392,208,600
2338,0,67,1,2,2,36,69,3,0,3,14,99,69,365,1,0,366,234,600
2339,1,95,1,0,1,42,88,2,4,0,32,80,55,401,3,1,405,195,600
2340,1,103,0,1,0,30,80,7,3,0,23,75,77,400,3,2,405,195,600
2341,1,87,2,0,1,32,113,2,2,2,19,90,67,418,6,0,424,176,600
2342,0,100,0,1,1,29,100,2,4,3,20,76,87,423,9,1,433,167,600
2343,0,80,0,1,3,39,110,4,1,0,28,72,78,416,1,0,417,166,583
2344,0,90,3,0,7,51,79,3,6,0,15,108,68,430,2,0,432,168,600
2345,0,89,1,1,4,45,83,5,2,1,29,88,68,416,4,1,421,179,600
2346,2,76,0,0,1,38,74,7,4,2,19,107,65,395,6,1,402,198,600
2347,2,89,1,1,6,44,73,6,4,4,17,108,58,413,2,0,415,185,600
2348,2,72,0,1,3,41,95,6,5,1,19,104,50,399,1,1,401,199,600
2349,3,90,0,0,2,32,85,5,1,1,21,100,68,408,3,0,411,189,600
2350,1,88,0,0,1,36,82,5,2,1,22,90,70,398,3,0,401,199,600
2351,1,88,1,0,3,34,73,8,11,4,19,104,50,396,5,1,402,198,600
2352,2,85,3,2,3,33,88,2,2,1,25,89,86,421,1,0,422,178,600
2353,0,89,1,2,2,54,78,7,2,0,16,101,34,386,5,1,392,208,600
2354,2,78,1,1,1,44,83,9,5,4,22,96,64,410,2,0,412,188,600
2355,3,89,2,0,2,51,112,5,5,3,19,95,58,444,6,1,451,149,600
2356,1,81,4,0,2,34,96,3,1,2,14,81,55,374,1,0,375,156,531
2361,1,6,0,2,0,1,19,1,0,1,5,24,3,63,1,0,64,395,459
2362,0,3,0,1,0,2,16,4,1,0,3,28,4,62,5,6,73,184,257
2363,1,12,1,0,1,2,24,0,0,1,4,37,2,85,0,0,85,275,360
2364,1,2,0,1,1,6,17,1,0,2,5,42,5,83,1,0,84,295,379
2365,0,3,0,4,0,1,15,1,0,0,2,48,3,77,0,1,78,443,521
2366,1,19,0,2,1,2,13,0,0,2,3,36,0,79,3,0,82,289,371
2367,0,10,1,0,0,2,23,0,0,0,1,23,6,66,0,0,66,61,127
2368,1,24,0,0,0,2,4,0,0,0,2,15,1,49,0,0,49,111,160
2369,1,5,1,0,1,0,7,2,0,0,1,19,2,39,1,0,40,97,137
1946,0,10,0,0,0,3,39,4,2,1,4,55,20,138,2,2,142,248,390
2168,0,93,1,0,2,33,58,0,3,1,24,111,32,358,4,1,363,237,600
2298,2,53,0,0,0,28,61,1,2,1,18,100,53,319,3,0,322,178,500
2320,0,71,0,1,0,20,83,3,4,1,9,75,33,300,2,0,302,128,430
2334,1,86,0,1,3,47,96,4,0,0,24,70,99,431,4,2,437,163,600
2357,1,74,1,0,2,27,73,4,2,4,20,87,55,350,1,0,351,180,531
2358,8,50,0,2,0,2,22,0,3,0,2,58,7,154,2,0,156,120,276
2359,1,11,1,0,0,3,8,0,0,3,2,16,2,47,4,0,51,281,332
2360,1,5,0,1,0,1,7,0,0,0,1,35,6,57,2,0,59,208,267
2370,0,96,0,0,0,41,76,5,2,0,19,100,71,410,2,0,412,188,600
2371,0,82,2,0,1,37,77,2,4,1,16,119,73,414,1,1,416,184,600
2372,3,72,2,0,4,28,55,7,4,0,23,147,45,390,3,1,394,206,600
2373,1,89,1,2,3,37,92,7,6,3,22,103,64,430,3,0,433,167,600
2374,1,81,0,1,2,43,72,8,3,0,25,98,54,388,1,0,389,211,600
2375,0,57,3,1,5,29,59,4,6,2,23,96,79,364,1,1,366,134,500
2376,2,88,0,0,2,31,65,3,3,1,18,111,59,383,2,0,385,125,510
2377,2,72,1,0,1,48,70,5,3,1,20,92,44,359,3,0,362,147,509
2378,0,79,0,0,5,39,81,3,3,2,24,104,55,395,5,0,400,200,600
2379,0,101,2,0,1,42,70,3,3,4,20,98,44,388,4,1,393,207,600
2380,1,92,4,1,2,48,95,4,4,2,14,85,41,393,3,2,398,202,600
2381,1,101,2,1,6,35,57,3,1,2,29,77,44,359,2,1,362,177,539
2382,2,68,0,1,3,23,47,6,2,1,10,123,67,353,3,4,360,142,502
2383,4,68,1,0,0,25,50,6,1,0,19,138,45,357,2,2,361,141,502
2384,0,51,0,0,6,20,58,5,0,6,9,109,19,283,2,1,286,224,510
2385,0,40,1,0,2,18,70,4,0,0,12,118,26,291,0,0,291,216,507
2386,1,93,1,1,2,48,105,3,4,2,19,95,49,423,4,0,427,173,600
2387,1,111,2,2,4,32,53,6,5,1,34,102,76,429,4,1,434,166,600
2388,2,109,2,0,4,50,58,4,6,1,29,98,54,417,5,0,422,178,600
2389,0,76,1,1,1,39,55,2,3,0,25,144,64,411,2,0,413,187,600
2390,0,104,1,1,2,44,52,2,2,2,40,95,60,405,4,0,409,191,600
2391,0,76,0,0,2,41,63,6,1,2,24,129,54,398,4,1,403,197,600
2392,2,96,1,2,1,29,56,3,2,3,23,117,63,398,3,0,401,199,600
2393,2,97,2,1,3,26,64,5,3,1,18,111,58,391,3,0,394,206,600
2394,2,94,2,1,2,55,60,11,1,1,35,118,48,430,2,0,432,168,600
2395,0,113,3,0,6,31,48,6,2,1,23,118,51,402,2,0,404,195,599
2396,0,92,1,1,2,38,52,5,6,2,34,109,64,406,5,3,414,186,600
2397,4,105,3,0,2,41,41,9,2,0,33,89,46,375,5,1,381,219,600
2398,2,108,0,1,2,51,57,4,2,2,27,94,44,394,1,0,395,205,600
2399,2,94,0,0,1,38,76,6,3,2,36,102,53,413,3,1,417,183,600
2400,0,74,1,0,1,28,49,2,5,3,47,88,34,332,2,2,336,164,500
2401,3,81,2,0,1,35,43,2,3,1,39,66,58,334,2,2,338,162,500
2402,0,66,2,0,3,34,38,2,5,1,29,89,65,334,1,0,335,165,500
2403,1,87,1,2,1,36,55,9,0,0,25,86,43,346,5,1,352,183,535
2404,1,95,3,0,3,44,80,3,4,0,18,104,49,404,3,0,407,193,600
2405,0,96,2,1,3,33,75,0,2,3,19,121,76,431,2,1,434,166,600
2406,1,103,1,1,4,22,94,2,5,2,19,116,55,425,4,1,430,170,600
2407,1,99,1,1,4,45,57,3,1,0,17,104,54,387,6,1,394,206,600
2408,1,82,3,0,3,47,62,4,3,1,23,104,49,382,7,2,391,209,600
2409,2,81,1,1,3,28,67,7,2,1,17,144,48,402,7,1,410,190,600
2410,2,100,1,1,1,32,68,6,3,3,21,103,63,404,3,0,407,193,600
2411,0,78,1,0,1,27,47,2,3,1,18,93,60,331,1,0,332,168,500
2412,0,77,4,1,2,33,60,3,2,4,11,77,44,318,2,0,320,180,500
2413,2,76,0,0,0,25,72,6,3,1,19,100,38,342,8,0,350,150,500
2414,2,76,1,1,1,23,48,2,0,2,16,89,55,316,3,1,320,180,500
2415,0,77,1,1,4,29,48,0,4,2,19,81,45,311,13,1,325,175,500
2416,4,97,1,0,1,45,63,2,4,1,18,88,55,379,3,0,382,183,565
2417,0,74,3,1,3,29,78,3,5,2,21,86,52,357,6,2,365,235,600
2418,2,69,0,1,0,46,61,4,15,1,30,73,48,350,6,0,356,228,584
2419,0,97,1,0,1,27,69,1,6,1,18,112,69,402,4,0,406,194,600
2420,0,70,1,0,2,39,52,5,2,3,17,86,71,348,5,0,353,147,500
2421,0,69,0,0,4,23,41,2,1,2,13,121,69,345,2,2,349,151,500
2422,0,66,2,0,0,26,53,8,1,0,12,109,68,345,2,0,347,153,500
2423,0,69,0,0,1,34,55,2,3,4,20,93,52,333,2,0,335,165,500
2424,2,76,0,1,1,33,53,3,0,0,16,97,63,345,4,1,350,150,500
2425,2,74,2,0,0,32,64,0,0,0,8,111,69,362,6,0,368,201,569
2426,2,69,1,2,3,29,33,2,2,0,16,88,62,309,2,0,311,139,450
2427,1,55,0,1,0,35,47,2,2,0,14,92,66,315,3,0,318,148,466
2428,0,51,1,2,0,14,41,3,2,0,13,62,60,249,4,1,254,119,373
2429,0,34,0,0,2,15,42,2,1,0,6,72,29,203,1,0,204,169,373
2430,2,40,2,1,4,11,40,2,1,0,5,23,30,161,2,0,163,83,246
2431,0,99,0,0,5,36,79,3,3,2,35,95,76,433,2,1,436,164,600
2432,2,70,0,1,3,10,53,7,1,10,17,87,64,325,1,1,327,173,500
2433,1,78,1,0,0,18,43,7,6,1,37,125,52,369,2,1,372,128,500
2434,1,82,0,1,0,15,66,7,7,3,31,105,61,379,3,0,382,177,559
2435,1,56,0,0,3,22,82,4,0,1,23,160,48,400,2,1,403,197,600
2436,1,57,1,0,2,23,57,4,1,0,8,127,46,327,5,2,334,266,600
2437,0,50,0,1,2,28,71,4,4,2,13,122,46,343,3,0,346,254,600
2438,2,47,0,1,1,24,77,6,3,2,18,138,47,366,6,0,372,228,600
2439,1,51,0,2,1,27,54,6,1,1,13,112,34,303,5,0,308,192,500
2440,1,58,1,0,2,24,54,2,1,0,17,123,53,336,5,0,341,198,539
2441,2,79,1,1,3,34,69,6,0,2,26,95,33,351,2,1,354,246,600
2442,2,89,0,3,4,34,60,3,3,5,23,88,35,349,2,0,351,199,550
2443,0,83,0,1,2,29,88,4,3,1,13,72,47,343,4,0,347,203,550
2444,1,76,1,2,2,27,51,5,2,2,17,104,42,332,5,0,337,213,550
2445,2,66,0,0,0,30,67,8,1,2,22,104,40,342,3,0,345,215,560
2446,0,64,0,0,0,27,58,3,0,1,21,71,38,283,6,1,290,110,400
2447,1,60,1,1,1,35,43,4,2,2,18,93,28,289,2,1,292,108,400
2448,1,81,1,2,0,47,59,0,2,0,21,96,44,354,4,1,359,140,499
2449,1,102,0,0,2,36,59,3,1,4,16,86,86,396,3,0,399,201,600
2450,0,71,0,0,3,47,60,5,3,1,14,111,79,394,5,1,400,200,600
2451,2,104,0,0,1,38,72,2,2,0,27,82,84,414,1,0,415,185,600
2452,1,62,1,0,2,37,72,2,6,3,19,64,59,328,2,1,331,169,500
2453,0,72,1,0,2,36,53,3,2,2,12,86,57,326,1,0,327,173,500
2454,0,99,1,0,2,52,63,3,7,3,16,70,63,379,2,0,381,193,574
2455,2,75,2,1,1,26,76,3,0,1,22,71,69,349,2,0,351,149,500
2456,1,55,0,0,2,26,118,3,1,2,11,78,50,347,1,3,351,149,500
2457,2,74,4,0,2,27,83,2,2,3,17,83,75,374,2,1,377,165,542
2458,1,18,1,0,0,14,58,2,1,3,16,97,34,245,6,1,252,148,400
2459,2,27,3,1,2,13,61,4,0,6,9,76,19,223,5,1,229,122,351
2460,1,50,0,0,2,26,46,4,1,1,23,119,79,352,5,2,359,141,500
2461,2,59,0,0,0,23,54,8,1,0,20,103,55,325,6,2,333,141,474
2462,0,8,0,1,0,2,24,1,0,0,5,9,11,61,0,0,61,18,79
2463,0,9,0,0,0,10,8,3,0,0,1,18,9,58,1,0,59,43,102
2464,0,201,0,0,5,44,57,3,8,3,28,66,35,450,2,4,456,144,600
2465,2,197,1,0,8,28,58,2,3,0,15,70,66,450,2,0,452,148,600
2466,1,152,1,0,6,42,66,4,8,1,23,82,60,446,3,1,450,150,600
2467,2,199,0,1,2,43,65,5,5,2,22,66,53,465,4,0,469,131,600
2468,2,185,0,1,4,42,72,2,5,0,13,62,62,450,1,1,452,148,600
2469,0,188,1,0,6,44,66,3,4,2,15,74,42,445,3,0,448,152,600
2470,0,188,0,0,2,34,66,7,9,3,21,60,56,446,4,0,450,150,600
2471,0,171,1,0,2,35,81,1,1,2,11,76,52,433,4,0,437,163,600
2472,0,184,0,0,5,42,75,3,11,0,17,59,47,443,6,1,450,150,600
2473,1,170,0,1,6,40,48,5,11,3,23,62,69,439,2,1,442,158,600
2474,0,168,3,1,7,36,59,2,6,1,32,60,73,448,3,0,451,149,600
2475,1,163,0,1,9,31,68,1,3,0,15,75,73,440,3,1,444,156,600
2476,2,193,2,4,5,41,78,4,4,0,23,56,47,459,4,0,463,137,600
2477,0,189,0,0,0,53,72,1,7,2,14,70,51,459,1,0,460,140,600
2478,0,176,1,3,2,28,63,2,2,1,24,50,77,429,1,1,431,169,600
2479,0,188,0,0,0,40,63,2,4,1,13,62,60,433,1,2,436,164,600
2480,0,190,3,0,3,29,61,0,6,2,23,58,55,430,4,1,435,165,600
2481,0,200,0,0,0,32,67,2,9,1,21,71,49,452,4,1,457,143,600
2482,2,174,1,2,6,51,45,5,4,2,16,77,56,441,3,3,447,153,600
2483,0,176,0,2,6,39,75,5,3,1,17,67,53,444,3,1,448,152,600
2484,0,177,1,2,5,47,58,0,6,1,11,56,37,401,5,0,406,144,550
2485,0,176,2,4,10,39,53,0,11,1,23,49,44,412,3,0,415,147,562
2486,0,168,0,0,1,38,92,1,4,1,20,66,51,442,2,1,445,155,600
2487,1,115,2,1,3,51,105,2,3,0,29,69,55,436,4,0,440,160,600
2488,0,111,0,2,2,35,67,4,5,4,19,51,49,349,2,0,351,149,500
2489,0,164,0,2,6,39,99,1,7,2,25,65,37,447,6,1,454,143,597
2490,1,89,1,2,3,34,37,3,0,3,18,45,29,265,4,0,269,143,412
2491,0,21,0,0,0,9,32,0,0,0,7,24,26,119,0,0,119,40,159
2492,2,68,0,2,3,32,36,1,3,0,18,47,25,237,3,0,240,81,321
2493,3,62,0,2,2,29,53,5,2,2,19,70,31,280,4,1,285,174,459
2494,3,146,2,0,2,67,41,5,8,3,20,75,68,440,3,0,443,157,600
2495,0,120,2,0,3,52,46,9,5,3,22,100,37,399,5,1,405,195,600
2496,2,160,0,0,2,45,42,4,3,6,16,87,45,412,3,0,415,185,600
2497,2,135,1,0,3,50,55,6,8,3,14,80,41,398,3,1,402,198,600
2498,2,138,0,1,2,49,48,4,5,3,14,82,32,380,4,2,386,214,600
2499,2,139,1,1,3,33,53,2,3,3,13,73,39,365,1,0,366,184,550
2500,0,165,0,0,1,38,47,1,4,3,19,80,37,395,3,0,398,152,550
2501,0,132,1,3,2,36,40,3,8,3,15,84,36,363,3,1,367,183,550
2502,0,153,2,0,4,49,59,2,10,0,23,42,50,394,3,4,401,149,550
2503,1,145,1,4,5,32,44,4,2,3,17,79,35,372,2,1,375,175,550
2504,1,126,1,0,3,56,37,0,3,1,26,74,34,362,3,0,365,162,527
2505,0,3,1,1,0,0,14,1,0,0,4,1,5,30,2,2,34,28,62
2506,1,105,2,0,6,31,42,3,3,1,17,86,30,327,2,0,329,171,500
2507,3,90,3,0,2,37,50,7,2,1,16,80,30,321,0,0,321,179,500
2508,0,101,2,0,1,46,40,3,1,0,21,77,28,320,4,3,327,173,500
2509,1,104,0,0,3,29,63,6,6,3,12,61,28,316,4,0,320,180,500
2510,0,115,2,2,2,31,42,1,3,1,13,71,42,325,4,1,330,170,500
2511,4,111,2,0,3,49,47,4,5,2,20,76,32,355,2,0,357,223,580
2512,0,83,3,1,1,44,38,4,1,3,31,50,47,306,5,2,313,187,500
2513,0,133,2,0,7,35,59,5,11,3,30,68,36,389,5,4,398,189,587
2514,1,76,2,0,1,17,53,5,4,1,13,16,23,212,1,2,215,70,285
2515,4,125,1,1,2,40,53,4,4,1,22,103,35,395,2,1,398,202,600
2516,0,118,1,2,4,30,64,3,3,0,13,121,47,406,1,1,408,192,600
2517,1,139,0,1,6,46,72,3,2,1,17,98,35,421,4,0,425,175,600
2518,2,124,1,0,6,43,66,1,1,2,26,97,47,416,4,3,423,177,600
2519,1,137,1,1,9,32,49,3,6,1,25,123,44,432,9,1,442,188,630
2520,1,47,0,0,2,31,26,8,1,1,20,68,27,232,2,0,234,116,350
2521,1,45,1,1,4,34,39,3,5,3,14,63,31,244,2,1,247,128,375
2522,1,104,0,0,3,20,89,2,2,1,13,31,20,286,2,0,288,55,343
2523,1,88,0,0,0,26,64,3,1,4,19,35,14,255,2,1,258,85,343
2524,3,126,0,2,3,12,60,1,2,1,14,43,11,278,1,1,280,120,400
2525,2,114,0,1,5,16,42,2,5,1,24,34,15,261,8,1,270,130,400
2526,3,146,1,1,2,25,55,2,1,3,26,43,23,331,3,0,334,139,473
2527,0,25,0,0,1,4,46,2,2,0,3,29,6,118,5,1,124,50,174
2528,0,54,1,0,0,20,21,0,0,0,21,7,25,149,2,0,151,49,200
2529,1,76,1,0,1,22,62,4,3,3,20,74,20,287,4,1,292,111,403
2530,0,64,1,1,1,34,77,3,2,2,24,56,21,286,3,0,289,113,402
2531,0,10,1,0,0,10,17,1,0,1,4,41,0,85,1,1,87,25,112
2532,0,35,0,0,0,17,18,1,1,1,3,16,7,99,5,2,106,31,137
2533,2,156,0,0,8,22,51,4,2,1,20,27,23,316,2,0,318,151,469
2534,1,173,3,3,2,54,54,3,8,0,21,87,44,453,2,1,456,144,600
2535,2,149,2,1,3,49,51,4,2,0,18,87,67,435,8,1,444,156,600
2536,2,129,1,0,8,36,64,1,4,0,19,100,60,424,4,0,428,172,600
2537,1,114,1,0,3,37,43,3,3,1,17,95,37,355,3,0,358,142,500
2538,1,133,1,2,2,24,50,2,4,1,32,89,29,370,3,2,375,202,577
2539,1,96,0,2,3,46,103,2,3,8,47,43,49,403,6,4,413,148,561
2540,3,82,1,1,2,49,47,5,6,2,24,107,41,370,6,1,377,223,600
2541,3,67,0,3,2,26,59,0,2,0,17,117,19,315,4,0,319,181,500
2542,2,74,2,1,4,37,76,2,2,1,39,68,40,348,2,4,354,146,500
2543,0,56,1,1,2,27,40,5,4,3,23,48,44,254,2,1,257,159,416
2544,1,77,2,0,2,61,73,6,4,1,31,42,26,326,7,0,333,145,478
2545,1,125,3,1,2,31,60,3,4,2,12,55,27,326,1,0,327,173,500
2546,2,107,0,1,1,28,87,1,1,3,13,76,32,352,5,1,358,142,500
2547,0,144,2,1,7,28,76,2,2,2,32,45,28,369,3,0,372,128,500
2548,0,136,0,0,3,42,38,7,4,4,23,60,28,345,4,2,351,105,456
2549,2,92,1,1,1,51,67,4,5,1,23,85,25,358,5,0,363,207,570
2550,1,76,0,0,2,61,51,8,0,1,35,91,21,347,4,1,352,218,570
2551,1,166,2,0,2,37,44,4,3,2,23,56,28,368,4,3,375,154,529
2552,1,131,2,0,3,44,53,5,2,2,36,41,31,351,5,0,356,173,529
2553,0,93,2,1,6,41,25,2,2,1,29,64,39,305,3,1,309,111,420
2554,2,111,0,1,4,39,36,4,5,1,17,90,22,332,7,0,339,161,500
2555,0,110,2,2,6,34,40,5,2,1,17,80,22,321,2,1,324,176,500
2556,0,88,0,0,3,32,46,5,1,3,13,90,13,294,4,2,300,150,450
2557,2,91,0,0,5,32,26,3,6,3,22,80,23,293,2,1,296,112,408
2558,3,149,1,0,7,40,61,4,2,2,15,89,38,411,4,0,415,185,600
2559,3,140,2,2,6,43,52,2,2,2,25,113,22,414,6,0,420,180,600
2560,2,129,0,1,3,25,38,3,4,0,17,80,31,333,5,0,338,162,500
2561,0,126,0,2,3,32,59,3,4,0,17,72,44,362,0,0,362,138,500
2562,0,118,1,1,3,47,48,1,5,1,20,81,36,362,2,0,364,136,500
2563,0,111,3,0,8,28,48,2,2,2,15,74,27,320,1,0,321,158,479
2564,0,92,0,1,0,27,46,0,4,3,12,55,20,260,0,1,261,139,400
2565,1,77,2,0,3,20,53,1,0,3,20,65,26,271,1,0,272,131,403
2566,2,67,2,1,0,27,68,2,4,0,20,67,35,295,3,1,299,171,470
2567,0,90,5,4,1,28,50,4,6,2,29,69,27,315,12,6,333,137,470
2568,0,94,1,0,1,50,46,2,15,4,23,67,17,320,1,1,322,140,462
2569,2,67,0,1,2,21,77,4,0,0,10,37,25,246,1,0,247,99,346
2570,3,108,1,2,0,52,70,6,6,1,28,94,40,411,2,3,416,184,600
2571,1,83,3,2,6,58,69,3,2,2,36,101,37,403,6,4,413,187,600
2572,1,87,1,0,3,54,92,3,4,1,31,84,48,409,4,2,415,199,614
2573,1,19,0,1,0,13,45,1,0,0,2,14,17,113,0,0,113,40,153
2574,0,24,1,0,1,5,4,1,0,0,3,26,4,69,0,0,69,27,96
2575,0,4,0,1,0,4,5,0,0,0,0,8,3,25,1,0,26,15,41
2576,3,56,3,1,6,30,53,3,6,1,33,157,30,382,7,1,390,230,620
2577,1,67,1,0,15,31,72,8,3,3,34,137,32,404,10,2,416,204,620
2578,4,45,2,0,4,32,70,14,0,3,13,112,30,329,3,0,332,168,500
2579,0,47,0,0,1,36,53,8,0,7,22,120,27,321,0,1,322,178,500
2580,0,45,0,0,3,28,62,19,1,4,28,108,16,314,4,0,318,182,500
2581,1,55,0,0,3,29,44,11,1,1,22,101,27,295,5,2,302,174,476
2582,1,66,1,1,15,84,40,4,3,2,65,92,37,411,5,0,416,210,626
2583,3,29,1,0,1,22,48,4,0,2,6,51,16,183,3,0,186,148,334
2584,3,25,0,0,0,31,66,4,0,0,7,71,8,215,2,1,218,116,334
2585,0,11,2,1,4,9,7,0,0,0,15,75,14,138,0,1,139,73,212
2586,0,32,0,1,1,79,53,8,5,2,15,184,24,404,6,0,410,221,631
2587,0,5,0,1,1,2,11,2,0,1,0,5,2,30,0,1,31,18,49
2588,4,70,1,1,6,37,45,4,1,2,25,86,22,304,5,1,310,140,450
2589,2,28,3,0,6,22,50,1,0,2,20,87,18,239,4,1,244,206,450
2590,0,44,1,1,2,26,31,4,1,0,18,74,39,241,3,1,245,185,430
2591,0,52,2,0,6,28,46,4,2,5,26,137,28,336,3,4,343,114,457
2592,2,61,1,2,2,30,33,6,5,6,19,141,42,350,16,2,368,132,500
2593,1,74,2,0,7,21,30,8,5,7,36,164,32,387,6,1,394,142,536
2594,1,129,1,1,2,50,73,1,7,0,17,67,104,453,1,0,454,146,600
2595,2,108,1,0,10,33,87,2,1,1,29,83,81,438,1,1,440,160,600
2596,3,85,4,0,6,38,72,0,2,1,11,115,97,434,4,0,438,162,600
2597,1,106,2,1,1,31,84,1,8,2,18,90,109,454,0,0,454,146,600
2599,1,111,2,0,4,50,72,3,8,2,24,93,68,438,1,0,439,161,600
2600,0,106,1,0,6,34,74,0,2,1,18,80,89,411,2,2,415,185,600
2601,1,128,2,1,4,39,102,2,4,3,12,79,78,455,4,0,459,141,600
2602,1,134,4,1,6,37,74,1,0,1,25,92,58,434,4,0,438,162,600
2603,1,97,2,0,2,52,70,2,4,2,19,89,94,434,5,2,441,159,600
2604,0,112,2,2,1,29,69,0,5,1,18,89,71,399,0,0,399,201,600
2605,2,104,3,2,4,41,62,0,4,1,28,93,88,432,1,1,434,166,600
2606,0,118,1,0,1,37,75,0,3,0,17,99,79,430,4,2,436,164,600
2607,0,105,1,2,5,35,80,1,3,2,21,99,79,433,1,0,434,166,600
2608,2,106,1,0,2,45,77,0,1,0,26,80,88,428,2,2,432,168,600
2609,0,111,3,1,3,39,66,2,2,0,29,91,97,444,4,1,449,151,600
2610,3,100,2,0,3,41,81,3,6,1,22,99,76,437,2,1,440,160,600
2611,0,93,0,0,3,30,73,0,1,0,9,82,85,376,1,0,377,123,500
2612,1,84,0,0,3,40,60,1,5,1,14,72,77,358,0,1,359,141,500
2613,2,100,4,0,3,29,96,1,1,1,12,98,72,419,0,0,419,141,560
2614,0,71,0,0,8,38,59,2,3,1,20,133,59,394,4,0,398,202,600
2615,0,74,0,0,5,32,69,6,1,1,22,148,42,400,5,1,406,194,600
2616,0,77,1,0,0,31,51,0,3,2,25,130,44,364,1,0,365,235,600
2617,0,97,2,1,5,51,69,3,3,3,21,116,53,424,2,1,427,152,579
2618,1,20,3,2,4,26,20,0,1,2,21,114,18,232,3,0,235,115,350
2619,2,31,0,0,3,28,29,2,0,3,22,122,22,264,3,0,267,128,395
2620,2,78,0,1,1,37,77,0,3,1,34,152,54,440,5,0,445,155,600
2621,0,77,1,0,2,19,46,3,3,1,52,139,53,396,2,0,398,152,550
2622,0,94,0,0,1,42,61,2,1,0,30,141,69,441,7,0,448,131,579
2623,0,84,1,1,3,36,96,5,5,1,16,106,83,437,4,0,441,190,631
2624,0,56,1,0,0,25,29,2,0,1,30,79,29,252,1,1,254,96,350
2625,3,71,0,0,1,20,38,2,4,1,24,73,44,281,1,0,282,85,367
2626,0,91,2,3,2,36,47,0,2,0,17,60,67,327,1,0,328,110,438
2627,1,82,1,0,3,31,47,1,0,0,13,83,73,335,2,0,337,101,438
2628,0,74,1,1,6,23,51,0,4,0,26,98,53,337,2,0,339,99,438
2629,0,110,1,0,2,25,112,4,6,1,41,95,105,502,1,0,503,114,617
2630,2,118,3,2,2,27,73,2,2,1,25,97,106,460,2,1,463,154,617
2631,2,133,1,0,4,31,97,3,1,0,24,94,102,492,6,0,498,117,615
2632,1,78,1,0,4,38,71,5,4,0,32,94,76,404,6,0,410,140,550
2633,2,74,1,1,3,31,92,3,1,1,46,95,59,409,7,1,417,133,550
2634,2,102,2,0,3,21,78,2,3,3,40,68,87,411,8,1,420,121,541
2635,0,90,2,0,5,33,56,2,1,0,35,46,46,316,2,2,320,100,420
2636,2,44,1,1,2,19,43,4,2,2,22,78,31,251,7,2,260,160,420
2637,2,67,2,1,2,32,52,2,2,1,33,71,34,301,0,2,303,118,421
2638,4,91,2,0,2,29,37,3,4,4,39,97,90,402,3,1,406,119,525
2639,2,79,1,1,4,28,79,6,1,2,44,89,88,424,4,0,428,185,613
2640,0,150,3,3,9,31,106,0,5,1,27,73,95,503,0,0,503,137,640
2641,0,101,2,2,2,23,100,1,3,1,34,112,66,447,2,0,449,151,600
2642,2,100,0,0,3,16,104,3,7,4,37,104,69,449,3,1,453,147,600
2643,0,111,2,1,2,37,63,2,1,2,44,123,73,461,3,1,465,135,600
2644,0,88,0,3,3,24,92,1,2,1,21,128,85,448,2,0,450,150,600
2645,1,91,1,1,3,24,95,3,3,1,33,85,71,412,0,0,412,88,500
2646,2,110,2,0,2,19,62,0,3,1,40,71,61,373,3,1,377,123,500
2647,0,94,0,0,0,30,72,3,4,3,20,95,68,389,1,1,391,123,514
2648,0,132,1,0,2,25,113,1,4,1,42,76,66,463,1,2,466,112,578
2649,1,140,2,3,4,34,65,2,3,2,27,85,75,443,6,0,449,151,600
2650,1,123,0,2,5,32,70,3,7,3,13,114,70,443,1,2,446,154,600
2651,4,98,0,2,7,32,55,3,2,2,22,78,46,351,2,0,353,147,500
2652,1,115,1,0,4,23,61,2,3,1,25,79,68,383,4,1,388,164,552
2653,0,77,1,0,2,14,95,2,0,2,23,75,66,357,5,2,364,86,450
2654,3,84,0,0,2,18,87,1,0,3,26,101,49,374,2,3,379,97,476
2655,2,79,1,0,0,7,31,0,1,0,13,32,31,197,0,1,198,51,249
2656,2,66,0,0,2,30,43,5,4,0,18,83,66,319,1,0,320,80,400
2657,0,70,0,0,3,15,40,4,4,0,16,73,50,275,4,0,279,83,362
2658,0,3,1,2,1,3,14,1,0,3,3,6,7,44,0,1,45,45,90
2659,2,55,0,1,0,30,60,6,2,1,35,111,71,374,8,1,383,167,550
2660,1,56,2,0,1,22,63,2,2,6,22,109,50,336,3,1,340,160,500
2661,1,66,0,0,3,20,72,1,0,2,23,95,63,346,2,1,349,151,500
2662,0,65,1,0,2,17,75,2,2,3,23,85,84,359,6,0,365,135,500
2663,0,75,0,0,0,25,45,0,3,1,42,70,62,323,5,0,328,163,491
2664,1,77,0,1,2,31,102,4,4,2,19,93,50,386,6,0,392,158,550
2665,3,61,1,0,3,34,89,2,0,1,28,89,66,377,6,0,383,179,562
2666,3,81,0,0,7,31,46,9,3,0,27,79,53,339,3,1,343,157,500
2667,1,68,1,2,5,29,46,1,1,0,28,74,33,289,3,0,292,158,450
2668,3,76,1,0,2,23,60,5,0,1,23,82,42,318,4,1,323,127,450
2669,2,88,3,1,2,40,41,1,2,2,26,87,37,332,8,0,340,149,489
2670,0,17,0,0,0,9,44,1,1,0,12,49,22,155,3,1,159,66,225
2671,1,97,2,0,2,26,93,3,5,2,17,137,46,431,2,1,434,166,600
2672,1,78,2,1,3,29,76,1,1,1,14,135,68,410,3,2,415,185,600
2673,0,70,1,0,1,26,69,2,1,2,14,109,52,347,4,2,353,206,559
2674,3,29,0,0,0,18,54,4,1,1,35,26,23,194,2,1,197,176,373
2675,3,59,1,0,1,30,32,1,0,3,28,81,24,263,3,1,267,232,499
2676,0,6,0,0,0,3,27,2,0,0,3,21,13,75,1,0,76,35,111
2677,1,49,1,0,1,11,31,3,1,0,52,87,11,248,3,1,252,248,500
2678,0,29,1,0,0,15,35,7,0,1,32,80,5,205,1,1,207,193,400
2679,0,36,0,1,2,15,31,3,1,2,53,50,9,203,3,0,206,211,417
2680,2,20,3,1,3,18,51,5,0,7,6,85,20,221,4,0,225,175,400
2681,2,26,0,0,1,13,32,4,3,1,3,87,21,193,3,0,196,166,362
2682,0,23,1,1,4,20,46,5,1,0,21,58,29,209,1,1,211,167,378
2683,1,6,0,0,0,9,16,0,0,20,0,0,4,56,0,0,56,45,101
2684,2,24,0,0,0,10,19,1,1,3,21,24,18,123,2,1,126,104,230
2685,0,4,0,0,0,7,3,0,0,1,3,8,3,29,1,0,30,5,35
2686,0,85,3,2,1,39,74,3,1,3,20,159,56,446,3,2,451,149,600
2687,1,93,2,0,1,23,69,1,3,1,26,152,60,432,6,0,438,162,600
2688,0,75,4,0,2,29,45,2,3,0,27,118,73,378,2,1,381,150,531
2689,3,115,1,1,6,34,75,2,5,3,25,126,63,459,3,0,462,138,600
2690,1,90,2,3,6,41,62,5,5,3,24,122,75,439,4,1,444,189,633
2691,0,66,1,0,1,47,74,2,1,1,23,108,28,352,9,0,361,139,500
2692,3,61,2,1,2,34,58,5,1,5,32,115,35,354,4,0,358,142,500
2693,2,53,0,0,0,25,60,4,0,0,23,129,31,327,4,1,332,168,500
2694,1,39,1,0,0,31,56,0,1,0,17,122,30,298,7,0,305,113,418
2695,1,81,2,1,3,47,46,0,4,2,10,93,59,349,1,0,350,113,463
2696,0,73,2,1,2,22,33,1,3,1,8,73,55,274,1,0,275,125,400
2697,1,76,1,3,0,27,50,2,2,1,14,78,51,306,2,0,308,92,400
2698,0,25,1,0,2,20,43,0,0,1,17,80,36,225,2,0,227,108,335
2699,2,64,2,4,2,25,51,3,2,7,23,168,47,400,5,1,406,220,626
2700,0,60,2,2,4,33,70,5,2,1,22,183,47,431,5,0,436,190,626
2701,0,95,2,2,3,23,66,3,9,1,30,80,73,387,2,0,389,111,500
2702,1,89,1,0,5,14,65,0,4,0,22,111,50,362,0,0,362,138,500
2703,0,80,1,1,3,22,66,1,2,1,29,77,74,357,2,1,360,140,500
2704,0,86,1,0,3,32,83,2,4,2,20,69,49,351,5,0,356,144,500
2705,1,92,1,1,1,24,92,1,1,2,26,85,59,386,5,1,392,133,525
2706,1,65,1,1,3,30,53,1,1,1,17,93,71,338,6,2,346,154,500
2707,1,62,1,1,1,10,42,0,0,3,21,100,60,302,4,1,307,193,500
2708,3,62,0,1,0,22,50,3,0,0,22,100,32,295,5,0,300,164,464
2709,0,60,0,0,2,18,28,1,3,0,37,59,37,245,2,0,247,103,350
2710,2,71,0,0,1,11,34,0,1,0,24,67,40,251,1,0,252,98,350
2711,0,68,0,0,2,23,50,1,3,2,29,71,17,266,3,3,272,78,350
2712,0,54,0,0,3,22,38,0,2,1,36,57,30,243,1,2,246,117,363
2713,0,24,0,0,3,4,26,3,1,0,25,51,13,150,5,0,155,89,244
2714,0,56,1,3,2,33,103,5,2,2,17,50,73,347,3,3,353,147,500
2715,1,47,1,0,1,26,106,2,3,2,30,45,59,323,2,1,326,174,500
2716,3,46,2,0,3,25,117,9,2,2,30,56,78,373,5,0,378,195,573
2717,0,62,0,0,2,39,80,4,0,0,37,29,53,306,1,0,307,204,511
2718,0,6,0,0,0,5,28,0,0,0,3,8,8,58,2,0,60,50,110
2719,0,3,0,1,1,1,12,1,0,0,9,1,12,41,0,0,41,26,67
2720,0,60,0,0,3,33,61,1,1,0,12,34,104,309,2,1,312,126,438
2721,1,28,0,0,0,4,12,1,0,0,3,8,9,66,1,0,67,72,139
2722,0,56,0,0,2,25,82,4,1,0,18,54,35,277,3,1,281,119,400
2723,0,39,0,0,2,28,84,1,0,1,18,60,38,271,3,0,274,125,399
2724,2,44,0,1,3,27,108,9,1,2,43,78,61,379,4,1,384,216,600
2725,1,23,0,0,0,9,67,2,0,0,30,48,26,206,4,0,210,155,365
2726,2,160,1,0,1,39,70,3,3,1,18,47,85,430,3,1,434,166,600
2727,2,122,3,1,3,30,69,5,5,3,23,63,114,443,1,0,444,156,600
2728,1,114,2,0,5,38,77,0,1,1,12,66,121,438,2,0,440,160,600
2729,1,131,1,1,2,36,88,3,4,2,11,59,127,466,1,1,468,132,600
2730,0,125,0,0,3,27,75,4,2,2,6,65,94,403,3,1,407,143,550
2731,0,134,0,1,5,33,71,3,4,0,23,71,69,414,1,0,415,135,550
2732,0,109,2,1,2,18,96,3,3,2,13,49,105,403,2,1,406,144,550
2733,1,120,0,0,0,27,92,4,2,1,3,78,79,407,2,1,410,144,554
2734,0,167,1,2,4,43,55,3,11,1,12,57,58,414,4,0,418,132,550
2735,0,164,2,1,3,33,57,3,1,1,25,53,82,425,3,1,429,121,550
2736,2,170,1,1,1,22,62,3,4,0,15,60,73,414,2,0,416,134,550
2737,3,180,2,0,3,23,42,1,4,0,6,75,50,389,4,0,393,141,534
2738,0,4,0,0,0,2,9,2,1,0,2,0,8,28,0,0,28,39,67
2739,2,98,0,1,3,15,83,2,1,2,26,59,79,371,2,1,374,126,500
2740,0,80,1,1,0,19,44,1,1,3,24,70,63,307,1,1,309,141,450
2741,1,91,1,0,2,25,56,0,2,1,20,33,76,308,2,0,310,140,450
2742,1,90,1,2,0,23,75,3,2,5,17,57,50,326,2,0,328,127,455
2743,1,136,1,0,7,41,63,6,4,2,25,79,75,440,2,0,442,158,600
2744,0,105,6,0,2,29,64,5,1,2,16,72,90,392,4,0,396,114,510
2745,2,93,2,1,4,46,63,7,4,4,26,89,67,408,6,0,414,186,600
2746,2,110,1,2,8,33,60,3,3,2,27,75,73,399,0,1,400,200,600
2747,1,85,2,0,1,37,54,2,3,2,21,84,63,355,8,1,364,186,550
2748,2,98,1,0,0,38,41,0,2,1,14,81,63,341,8,0,349,169,518
2749,2,129,1,0,1,62,73,9,5,3,32,63,70,450,2,0,452,185,637
2750,2,78,1,2,1,19,32,2,0,2,26,60,83,308,8,1,317,133,450
2751,3,86,1,0,1,16,41,4,2,3,26,42,105,330,1,1,332,119,451
2752,2,74,1,1,2,18,33,3,1,2,10,60,40,247,2,1,250,85,335
2753,1,107,1,1,2,4,43,2,0,1,11,39,43,255,0,0,255,80,335
2754,0,78,3,0,1,31,72,2,2,3,14,74,98,378,4,0,382,148,530
2755,0,82,0,0,4,43,68,2,1,0,18,80,87,385,0,0,385,145,530
2756,2,72,1,1,1,38,68,2,1,4,27,97,73,387,8,0,395,135,530
2757,4,93,0,1,2,34,76,0,0,0,16,82,97,405,3,0,408,121,529
2758,1,85,0,0,2,65,69,14,0,0,34,86,91,447,5,2,454,189,643
2759,1,90,1,0,2,49,63,1,1,0,19,98,80,405,1,0,406,194,600
2760,0,73,2,0,4,55,76,3,2,0,15,93,84,407,3,1,411,208,619
2761,2,58,1,0,0,14,66,3,0,3,13,147,45,352,4,0,356,144,500
2762,2,58,1,3,5,19,39,0,2,4,13,107,42,295,10,1,306,194,500
2763,0,85,1,1,1,24,41,1,2,2,9,136,54,357,6,1,364,165,529
2764,0,77,0,0,6,20,118,3,0,0,12,54,72,362,2,1,365,157,522
2765,0,17,0,1,1,8,22,0,0,1,4,12,8,74,0,0,74,27,101
2766,1,117,2,2,1,22,84,1,2,2,23,72,81,410,5,1,416,184,600
2767,0,94,0,0,1,28,87,2,5,2,22,104,77,422,1,1,424,176,600
2768,3,105,1,1,2,43,75,2,3,3,22,79,62,401,2,2,405,195,600
2769,0,120,0,1,2,35,76,2,5,2,30,70,85,428,2,0,430,170,600
2770,1,95,0,1,2,38,74,3,1,1,26,89,70,401,6,0,407,193,600
2771,2,89,2,2,1,38,52,1,1,3,30,100,60,381,3,0,384,216,600
2772,1,102,3,2,2,28,56,4,6,3,14,103,76,400,4,1,405,195,600
2773,1,96,3,0,0,31,79,1,2,2,18,87,70,390,5,1,396,204,600
2774,0,99,2,0,3,35,59,4,3,3,30,87,87,412,4,0,416,184,600
2775,1,118,0,1,6,28,82,5,4,3,19,82,84,433,1,0,434,166,600
2776,0,87,2,0,3,16,83,1,3,4,16,62,78,355,6,0,361,139,500
2777,2,102,1,1,4,30,41,5,2,2,19,78,68,355,1,0,356,144,500
2778,0,88,3,0,2,23,65,2,1,7,20,73,72,356,4,1,361,139,500
2779,3,125,1,2,4,21,74,1,0,0,27,81,80,419,4,0,423,170,593
2780,2,103,1,0,3,30,59,1,9,2,26,82,29,347,3,0,350,180,530
2781,1,103,1,1,1,52,50,1,7,5,34,64,44,364,6,0,370,160,530
2782,1,100,0,0,3,31,83,4,8,1,21,61,51,364,6,0,370,160,530
2783,1,96,3,2,0,30,56,3,8,6,32,66,52,355,4,0,359,181,540
2784,1,75,0,2,1,15,32,3,1,1,27,68,63,289,5,2,296,99,395
2785,0,53,1,1,1,26,60,5,1,1,16,58,43,266,4,4,274,121,395
2786,3,90,1,2,1,29,73,1,3,2,25,91,50,371,4,1,376,175,551
2787,1,94,0,5,2,23,54,5,0,4,18,105,62,373,3,0,376,175,551
2788,1,91,0,1,1,43,61,3,3,1,17,91,59,372,6,2,380,171,551
2789,0,8,0,0,1,1,6,0,1,0,0,2,4,23,0,0,23,33,56
2790,0,97,0,0,1,32,68,7,3,1,17,107,71,404,4,1,409,191,600
2791,0,95,1,0,2,34,63,4,2,2,18,135,52,408,9,0,417,183,600
2792,0,109,0,0,1,28,89,2,1,2,27,81,68,408,0,0,408,142,550
2793,0,80,2,0,1,26,46,4,1,2,22,98,55,337,6,1,344,187,531
2794,0,44,0,1,0,22,48,3,1,0,23,62,39,243,6,1,250,126,376
2795,2,136,0,1,5,45,78,1,7,5,37,71,44,432,4,1,437,163,600
2796,1,126,0,1,3,47,77,3,2,2,34,53,60,409,4,2,415,185,600
2797,0,94,3,0,1,10,89,2,1,0,17,40,40,297,1,0,298,74,372
2798,1,88,0,2,0,52,32,1,0,2,39,33,78,328,4,1,333,80,413
2799,0,60,0,0,0,35,26,4,4,0,10,27,19,185,3,2,190,80,270
2800,0,81,0,0,3,28,94,4,1,1,36,86,77,411,8,0,419,181,600
2801,2,79,2,0,1,25,73,2,1,1,21,103,57,367,3,2,372,228,600
2802,0,121,0,1,1,43,94,2,0,6,36,105,62,471,1,1,473,167,640
2803,2,88,0,1,1,25,54,6,3,2,27,82,60,351,2,2,355,132,487
2804,1,88,1,1,2,26,36,4,2,1,32,75,76,345,7,1,353,134,487
2805,0,68,1,1,1,35,69,2,3,2,40,58,71,351,3,2,356,168,524
2806,0,76,0,0,2,37,46,1,2,1,23,80,85,353,2,0,355,145,500
2807,1,54,1,1,0,34,58,1,4,1,37,63,73,328,6,0,334,166,500
2808,0,48,1,0,3,39,56,1,0,1,21,95,56,321,7,1,329,171,500
2809,3,75,2,1,4,32,80,2,4,2,32,76,53,366,5,0,371,160,531
2810,1,30,5,0,3,16,78,0,3,2,25,14,32,209,3,0,212,115,327
2811,1,90,2,0,0,20,87,1,0,1,18,39,65,324,1,1,326,129,455
2812,1,93,1,0,1,24,88,2,0,0,15,55,62,342,1,1,344,111,455
2813,0,98,1,0,0,25,55,0,4,0,19,74,97,373,1,0,374,126,500
2814,0,78,0,1,1,27,49,4,2,2,23,76,65,328,0,1,329,171,500
2815,0,83,2,1,3,31,59,0,2,1,22,49,86,339,4,0,343,134,477
2816,1,73,3,0,0,33,53,1,5,1,28,103,55,356,8,2,366,134,500
2817,1,90,0,0,1,16,32,1,1,3,23,118,36,322,0,0,322,178,500
2818,0,62,1,0,1,21,61,0,5,1,21,112,54,339,5,1,345,155,500
2819,2,93,0,0,0,29,62,1,3,1,28,110,44,373,2,2,377,123,500
2820,0,83,3,0,3,28,84,0,1,3,29,118,55,407,3,0,410,166,576
2821,0,22,1,0,0,27,17,0,0,0,5,13,15,100,2,0,102,24,126
2822,0,74,1,1,3,22,49,2,3,0,24,43,86,308,2,1,311,139,450
2823,1,76,1,0,1,28,46,0,1,2,13,25,93,287,8,0,295,105,400
2824,1,71,1,1,2,20,45,3,5,0,20,33,93,295,2,0,297,124,421
2825,1,101,4,3,3,26,64,2,3,1,25,57,50,340,4,3,347,153,500
2826,1,113,1,0,1,27,67,3,0,5,23,39,81,361,1,1,363,137,500
2827,1,134,2,0,1,27,42,0,2,0,29,60,50,348,6,0,354,149,503
2828,1,104,2,5,0,33,78,3,1,1,42,49,58,377,1,1,379,210,589
2829,0,120,1,0,3,39,138,2,2,3,14,50,88,460,2,0,462,138,600
2830,1,150,1,0,2,30,108,2,4,3,14,48,88,451,3,2,456,144,600
2831,0,134,0,0,5,37,151,3,4,1,8,63,87,493,2,1,496,104,600
2832,2,122,1,2,4,44,103,2,2,3,11,54,72,422,0,0,422,178,600
2833,1,153,0,0,3,32,88,2,8,1,12,58,85,443,4,0,447,153,600
2834,1,152,0,0,4,20,84,1,7,1,11,35,64,380,3,0,383,117,500
2835,2,137,1,0,3,33,86,2,1,2,13,35,76,391,2,0,393,107,500
2836,1,135,0,1,2,21,72,0,2,0,10,37,84,365,3,1,369,131,500
2837,1,128,0,1,1,34,98,1,0,1,16,34,88,403,3,1,407,105,512
2838,2,96,0,1,4,32,95,4,0,1,11,45,70,361,0,0,361,139,500
2839,0,99,3,0,2,30,91,0,2,2,16,77,37,359,2,0,361,139,500
2840,1,94,1,1,2,33,71,2,3,0,14,76,49,347,2,0,349,151,500
2841,0,111,1,1,3,19,78,0,1,2,20,54,91,381,1,0,382,118,500
2842,0,119,0,0,3,28,79,2,3,0,25,58,72,389,5,1,395,105,500
2843,1,137,0,4,3,25,56,2,0,1,20,70,85,404,6,1,411,189,600
2844,1,117,1,1,1,34,61,3,4,1,21,45,74,364,3,0,367,133,500
2845,1,116,2,0,1,35,62,1,0,2,17,36,86,359,6,0,365,135,500
2846,0,89,0,0,6,36,58,5,4,3,21,50,106,378,2,1,381,119,500
2847,0,119,1,1,7,22,58,2,5,2,11,52,74,354,2,0,356,144,500
2848,0,154,1,1,4,47,106,0,4,2,13,44,81,457,3,2,462,109,571
2849,3,84,0,0,3,36,92,0,2,1,17,67,48,353,2,2,357,143,500
2850,1,101,1,3,2,46,84,2,2,3,15,72,42,374,4,1,379,157,536
2851,0,77,0,0,1,32,81,3,7,0,13,71,51,336,6,0,342,114,456
2852,2,120,0,2,5,23,47,0,3,2,19,67,60,350,1,1,352,104,456
2853,1,128,1,0,4,52,80,1,5,2,19,89,67,449,2,0,451,149,600
2854,0,133,2,3,5,43,91,5,2,2,25,56,95,462,4,0,466,134,600
2855,2,117,1,1,2,51,72,1,1,1,17,87,78,431,4,0,435,165,600
2856,1,114,0,1,1,42,75,6,3,3,21,83,55,405,6,0,411,189,600
2857,1,132,3,2,7,48,79,5,5,3,31,72,81,469,10,0,479,121,600
2858,1,114,1,2,3,33,88,4,1,2,7,80,118,454,9,0,463,137,600
2859,0,132,1,1,5,48,93,4,3,2,14,74,68,445,2,0,447,153,600
2860,1,103,3,1,5,38,76,3,2,3,21,60,98,414,4,1,419,131,550
2861,2,119,1,3,1,38,88,1,7,4,15,67,66,412,3,0,415,124,539
2862,1,110,1,3,8,34,87,0,2,0,16,66,82,410,6,0,416,194,610
2863,1,92,0,2,7,40,88,4,1,0,23,74,59,391,8,1,400,210,610
2864,1,118,0,0,2,38,74,2,4,2,10,58,81,390,9,3,402,201,603
2865,3,63,0,0,3,44,55,3,2,2,14,73,64,326,3,2,331,169,500
2866,0,56,1,0,1,49,79,4,0,1,19,75,45,330,3,0,333,167,500
2867,0,71,1,0,1,34,92,4,6,1,20,84,60,374,5,2,381,193,574
2868,1,109,0,1,1,36,61,1,1,0,23,119,48,401,3,0,404,196,600
2869,1,93,0,2,1,43,50,9,5,5,10,129,53,401,6,0,407,193,600
2870,0,99,1,0,2,30,65,6,3,3,9,99,79,396,3,0,399,201,600
2871,2,95,2,0,7,39,85,2,3,3,13,129,47,427,6,0,433,167,600
2872,1,76,2,2,3,34,75,12,0,3,12,109,55,384,1,0,385,215,600
2873,2,86,0,2,2,42,82,2,4,0,16,97,60,395,2,0,397,153,550
2874,1,83,0,0,1,40,76,6,4,1,20,68,68,368,11,1,380,170,550
2875,0,96,0,2,2,59,61,1,3,3,13,87,51,378,2,1,381,181,562
2876,0,130,0,4,7,51,86,0,5,2,19,97,70,471,4,1,476,124,600
2877,1,126,2,3,2,33,91,2,6,1,19,66,76,428,6,1,435,165,600
2878,0,143,0,0,7,51,87,5,4,1,17,86,58,459,5,1,465,135,600
2879,0,120,0,0,3,62,81,2,4,2,15,93,71,453,1,1,455,145,600
2880,0,138,1,1,3,37,71,2,2,4,18,56,65,398,1,1,400,123,523
2881,0,2,0,2,1,1,29,1,0,1,1,2,9,49,0,0,49,21,70
2882,1,122,1,1,3,33,102,3,4,2,29,95,51,447,3,0,450,150,600
2883,1,122,0,0,4,39,100,3,5,2,26,75,82,459,2,0,461,139,600
2884,1,131,2,1,7,42,69,2,1,2,37,75,80,450,3,1,454,146,600
2885,3,105,2,1,3,33,103,3,3,3,21,87,68,435,5,2,442,158,600
2886,2,132,0,2,6,28,98,2,2,6,24,91,53,446,0,0,446,154,600
2887,0,123,2,0,0,30,54,2,3,1,16,82,80,393,0,1,394,206,600
2889,3,126,4,0,4,37,84,3,2,2,24,57,97,443,6,0,449,151,600
2890,0,117,4,0,2,32,97,2,4,2,31,74,114,479,4,0,483,117,600
2891,2,121,3,1,4,28,87,4,4,2,23,75,92,446,6,0,452,148,600
2892,2,133,1,0,7,38,99,6,5,4,35,79,78,487,4,0,491,137,628
2893,2,44,0,0,2,21,46,1,1,0,12,70,39,238,2,1,241,109,350
2894,1,48,0,1,2,23,41,4,0,0,17,88,34,259,3,1,263,109,372
2895,0,4,0,0,0,1,6,0,0,0,8,2,3,24,0,0,24,18,42
2896,3,82,1,2,5,30,94,1,4,1,21,105,76,425,3,1,429,146,575
2897,0,82,2,1,4,36,97,0,1,2,22,92,66,405,4,1,410,165,575
2898,1,83,1,0,1,24,84,6,1,3,26,94,79,403,4,3,410,143,553
2899,2,57,0,2,3,24,38,2,0,0,25,62,33,248,3,1,252,103,355
2900,0,48,1,0,0,21,52,1,0,4,24,47,32,230,4,1,235,121,356
2901,2,106,1,0,2,29,121,4,2,0,35,84,78,464,4,3,471,104,575
2902,1,114,1,0,0,29,144,3,3,1,21,60,103,480,1,0,481,94,575
2903,2,101,1,0,0,28,108,1,2,0,24,75,97,439,3,1,443,107,550
2904,0,96,1,0,1,21,119,1,3,0,25,59,112,438,5,0,443,117,560
2905,1,141,2,1,2,21,117,1,2,3,24,80,89,484,1,1,486,134,620
2906,3,73,1,0,2,23,57,5,2,5,16,63,41,291,5,0,296,104,400
2907,1,66,1,0,1,17,88,6,3,2,14,78,39,316,2,1,319,111,430
2908,1,78,0,0,0,41,74,4,1,3,23,128,66,419,2,0,421,179,600
2909,2,74,2,1,1,25,62,2,1,1,24,155,40,390,3,2,395,205,600
2910,0,70,2,1,3,26,54,6,3,2,19,150,64,400,8,0,408,192,600
2911,3,75,1,1,1,37,65,3,4,3,20,134,47,394,4,1,399,201,600
2912,1,77,2,0,0,43,66,5,0,4,17,140,50,405,2,1,408,192,600
2913,1,56,0,2,3,25,59,3,1,1,16,112,48,327,0,0,327,173,500
2914,3,65,0,1,0,29,57,4,2,4,18,113,31,327,2,0,329,171,500
2915,1,74,0,0,0,27,76,2,1,1,17,115,44,358,1,1,360,173,533
2916,2,95,0,0,0,17,81,4,1,0,20,86,47,353,2,0,355,145,500
2917,4,60,2,2,3,28,81,1,1,0,15,107,54,358,4,1,363,137,500
2918,1,69,1,0,3,33,76,2,0,0,16,109,55,365,0,0,365,135,500
2919,2,120,0,2,2,22,116,0,3,0,12,96,59,434,4,1,439,119,558
2920,2,57,2,0,0,22,52,4,4,1,23,163,42,372,9,2,383,192,575
2921,2,68,3,0,1,41,54,5,3,2,22,143,42,386,2,1,389,186,575
2922,0,54,2,1,2,24,86,1,5,1,20,156,26,378,1,0,379,185,564
2923,2,49,0,1,0,32,89,2,5,3,15,86,93,377,3,0,380,220,600
2924,1,57,0,0,2,26,104,1,2,1,19,78,100,391,3,0,394,206,600
2925,0,60,1,1,0,25,82,4,2,0,23,76,96,370,3,0,373,227,600
2926,1,63,0,0,3,26,115,1,5,2,22,64,81,383,4,1,388,212,600
2927,4,59,0,1,2,31,100,3,2,0,22,82,89,395,1,0,396,204,600
2928,1,54,1,1,2,42,85,5,3,2,19,87,97,399,2,0,401,199,600
2929,0,73,0,1,0,41,86,1,9,2,13,89,88,403,1,0,404,196,600
2930,0,58,0,0,0,34,86,0,3,1,23,79,87,371,2,1,374,226,600
2931,0,42,0,0,1,32,94,5,2,0,22,85,81,364,2,3,369,231,600
2932,1,64,0,1,3,19,110,1,1,3,13,82,88,386,4,0,390,210,600
2933,0,66,1,2,4,22,74,1,0,0,15,78,98,361,0,1,362,188,550
2934,0,60,1,3,0,23,94,0,1,2,18,57,53,312,3,1,316,209,525
2935,1,42,0,0,1,24,67,1,0,1,19,69,67,292,4,0,296,160,456
2936,0,62,2,0,0,19,72,0,0,1,7,49,80,292,2,1,295,162,457
2937,1,1,0,0,0,0,12,0,0,0,3,0,3,20,0,0,20,7,27
2938,0,53,1,0,1,28,82,1,4,1,25,48,57,301,1,3,305,195,500
2939,0,45,0,0,0,51,71,3,3,1,19,64,54,311,5,0,316,184,500
2940,0,57,2,0,2,27,58,2,0,3,21,93,66,331,3,1,335,233,568
2941,0,52,1,0,1,22,54,5,3,0,10,51,94,293,6,0,299,156,455
2942,0,28,3,1,5,27,65,0,2,0,10,77,60,278,5,0,283,172,455
2943,0,25,1,1,3,28,72,5,0,1,27,48,73,284,1,3,288,212,500
2944,1,29,0,0,4,26,54,3,0,2,22,63,63,267,2,0,269,231,500
2945,0,45,0,0,0,38,68,3,1,1,16,48,58,278,2,0,280,220,500
2946,1,35,0,1,0,18,54,3,0,0,16,46,59,233,3,2,238,205,443
2947,0,15,0,0,0,17,80,2,0,0,12,81,40,247,6,0,253,347,600
2948,3,24,2,1,5,30,84,4,1,0,17,87,32,290,6,0,296,304,600
2949,0,9,1,0,1,22,81,1,0,0,13,85,32,245,5,1,251,303,554
2950,1,23,0,0,0,11,34,0,0,1,8,33,22,133,1,0,134,69,203
2951,0,15,1,0,1,12,48,2,1,0,8,53,26,167,4,0,171,136,307
2952,1,24,1,0,0,11,59,2,0,0,4,37,23,162,0,0,162,129,291
2953,0,30,0,0,0,35,82,1,2,2,13,172,21,358,6,0,364,239,603
2954,1,83,1,0,16,45,68,4,4,0,10,101,116,449,3,0,452,148,600
2955,1,72,0,1,7,40,95,0,3,5,10,108,101,443,1,0,444,156,600
2956,2,84,1,0,4,35,96,1,1,2,6,89,89,410,2,0,412,188,600
2957,0,94,3,0,3,43,100,2,2,1,6,89,77,420,1,2,423,177,600
2958,0,81,1,2,3,59,87,3,2,1,11,93,78,421,1,0,422,178,600
2959,0,84,1,1,4,48,81,3,3,2,6,99,92,424,4,2,430,170,600
2960,1,72,1,2,6,44,69,1,1,1,15,115,71,399,2,0,401,199,600
2961,1,92,0,0,5,30,90,2,1,0,14,84,99,418,6,0,424,176,600
2962,1,74,0,0,3,39,63,1,0,1,8,87,80,357,1,0,358,142,500
2963,1,65,0,0,4,36,92,1,7,2,5,51,121,385,3,2,390,110,500
2964,2,71,3,0,3,33,55,2,2,0,10,94,76,351,2,0,353,147,500
2965,1,73,0,0,2,32,64,2,1,1,10,110,69,365,2,1,368,132,500
2966,2,95,2,0,7,39,85,2,9,0,10,94,90,435,4,0,439,148,587
2967,0,57,2,0,7,22,67,0,3,1,15,87,43,304,3,0,307,133,440
2968,1,65,1,2,9,35,44,4,1,0,17,88,42,309,6,1,316,124,440
2969,0,92,1,0,3,41,61,2,15,1,26,97,88,427,5,2,434,166,600
2970,0,107,2,0,8,31,83,3,14,4,23,116,80,471,4,0,475,151,626
2971,0,83,0,0,2,11,55,2,1,0,8,25,18,205,2,0,207,45,252
2972,3,52,1,0,1,36,34,2,1,0,7,71,64,272,3,0,275,106,381
2973,2,51,1,0,4,30,46,0,1,1,10,75,58,279,5,1,285,96,381
2974,1,95,1,0,5,55,43,2,1,1,11,136,40,391,6,1,398,202,600
2975,5,60,1,0,0,77,56,3,0,1,13,122,32,370,7,2,379,221,600
2976,2,83,3,1,5,49,69,1,4,1,12,104,29,363,4,0,367,211,578
2977,0,70,3,0,1,34,59,1,3,0,11,90,88,360,2,1,363,92,455
2978,4,68,0,0,5,33,63,3,4,1,12,93,63,349,0,1,350,104,454
2979,2,84,1,0,5,37,48,4,0,4,11,164,64,424,2,2,428,172,600
2980,2,81,2,1,5,35,58,2,4,3,19,151,58,421,9,1,431,169,600
2981,6,73,2,0,4,44,55,3,2,0,10,153,47,399,3,1,403,197,600
2982,1,51,2,0,4,32,41,1,4,2,15,127,52,332,2,2,336,164,500
2983,2,65,0,0,7,42,45,1,2,2,21,141,44,372,1,3,376,124,500
2984,2,67,0,0,4,35,43,3,8,2,17,159,43,383,6,3,392,169,561
2985,1,8,0,0,0,4,25,0,0,0,1,24,8,71,2,0,73,41,114
2986,0,111,1,2,15,49,79,2,5,1,8,84,88,445,2,0,447,153,600
2987,0,101,1,0,3,40,61,2,6,1,16,101,109,441,2,1,444,156,600
2988,1,99,0,0,8,30,77,1,5,0,16,130,81,448,2,0,450,150,600
2989,2,111,1,0,7,32,78,1,4,2,14,104,89,445,4,0,449,151,600
2990,1,77,0,0,8,45,75,1,10,1,8,93,87,406,5,1,412,138,550
2991,0,91,2,0,9,45,54,2,0,0,7,92,117,419,3,0,422,128,550
2992,3,74,0,0,7,43,65,1,1,3,11,111,87,406,3,0,409,143,552
2993,0,30,0,2,3,33,44,1,2,0,10,140,26,291,3,1,295,155,450
2994,0,39,2,0,3,34,36,1,2,3,6,137,40,303,6,0,309,139,448
2995,3,88,0,0,5,40,72,2,4,5,13,120,79,431,4,0,435,165,600
2996,1,95,3,0,10,36,68,2,0,3,16,122,85,441,4,1,446,154,600
2997,0,91,0,0,4,55,75,1,3,1,15,115,61,421,1,0,422,178,600
2998,3,61,1,0,8,29,65,4,2,4,12,132,84,405,2,0,407,193,600
2999,0,73,1,0,4,31,55,5,3,0,14,138,79,403,1,0,404,196,600
3000,2,77,1,1,6,41,61,2,5,5,13,117,91,422,4,0,426,174,600
3001,0,57,1,0,1,35,72,2,6,2,9,99,79,363,2,0,365,135,500
3002,3,79,1,1,5,28,65,0,4,0,11,88,79,364,2,0,366,134,500
3004,3,76,0,1,3,16,62,4,3,2,16,87,81,354,4,3,361,156,517
3005,0,2,1,0,0,1,20,0,0,2,0,1,8,35,0,1,36,32,68
3006,7,45,1,0,1,39,50,2,3,1,5,167,19,340,5,2,347,203,550
3021,1,54,1,0,4,31,45,2,4,2,19,118,60,341,6,0,347,153,500
3022,4,48,0,0,3,27,51,1,0,3,20,97,80,334,3,0,337,163,500
3023,2,67,0,1,0,46,50,0,2,0,12,136,80,396,12,2,410,158,568
3024,1,35,1,1,2,34,28,5,0,1,12,54,23,197,1,1,199,77,276
3025,2,51,1,0,4,37,63,3,1,0,8,112,41,323,6,3,332,168,500
3041,0,29,1,0,1,26,41,2,5,2,11,55,42,215,1,1,217,82,299
3042,1,65,0,1,1,49,57,2,1,4,21,149,46,397,2,0,399,201,600
3061,3,18,2,1,1,23,58,4,0,2,16,227,28,383,10,2,395,240,635
3062,0,39,1,0,3,31,53,0,0,2,17,116,46,308,3,0,311,129,440
3063,2,32,0,1,1,28,34,2,5,2,19,116,56,298,2,0,300,140,440
3064,0,30,1,0,3,16,30,2,7,6,18,105,55,273,4,0,277,114,391
3065,3,5,1,0,0,13,41,3,0,1,8,141,8,224,6,0,230,125,355
3081,5,61,3,1,4,34,68,1,1,2,19,104,70,373,3,1,377,223,600
3082,1,45,1,0,5,32,61,5,1,2,20,110,77,360,2,1,363,237,600
3083,3,65,0,0,0,36,65,10,2,3,24,108,54,370,5,0,375,225,600
3084,3,57,0,0,2,31,37,6,1,2,18,94,45,296,3,0,299,201,500
3085,1,53,0,0,2,32,38,2,2,4,13,109,52,308,6,1,315,185,500
2598,0,91,3,6,32,76,3,8,1,14,118,76,1,429,0,0,429,171,600
2888,2,127,0,1,1,46,108,2,2,2,30,86,79,486,5,1,492,108,600
3003,0,85,0,0,3,28,65,1,2,0,14,92,56,346,4,2,352,148,500
3007,0,43,1,0,2,34,34,6,5,2,7,152,35,321,7,0,328,187,515
3008,0,14,0,1,4,6,11,4,0,1,3,25,7,76,0,0,76,17,93
3009,0,66,2,1,6,38,41,3,2,1,7,107,74,348,2,2,352,148,500
3010,0,68,2,1,2,29,57,4,1,0,18,104,69,355,1,1,357,143,500
3011,1,74,2,0,2,26,58,3,0,1,16,118,71,372,5,1,378,122,500
3012,1,55,2,0,1,24,45,1,1,1,10,105,56,302,3,0,305,112,417
3013,1,119,1,0,5,38,64,3,4,2,20,105,102,464,2,0,466,134,600
3014,1,109,1,2,11,36,66,0,2,1,8,117,103,457,2,0,459,141,600
3015,0,108,0,0,5,30,70,0,4,2,14,102,74,409,2,1,412,138,550
3016,0,117,2,1,2,30,59,3,1,2,16,98,93,424,2,0,426,124,550
3017,0,102,2,0,5,35,51,2,5,0,11,95,77,385,2,0,387,120,507
3018,0,67,2,0,11,37,59,2,3,3,30,128,78,420,9,0,429,171,600
3019,1,58,3,2,3,39,58,5,6,2,25,133,65,400,7,1,408,192,600
3020,0,46,3,1,6,39,44,2,2,1,22,104,62,332,4,0,336,164,500
3026,1,34,1,0,1,36,60,1,0,2,17,110,59,322,5,1,328,181,509
3027,3,69,6,0,2,29,74,4,3,2,28,120,73,413,4,0,417,183,600
3028,0,65,3,2,4,20,65,6,0,1,19,96,73,354,5,2,361,139,500
3029,3,57,1,0,1,23,66,2,3,0,23,86,67,332,2,2,336,164,500
3030,3,78,0,0,4,47,65,2,3,2,24,109,73,410,1,0,411,166,577
3031,1,35,1,0,3,23,60,4,1,1,20,198,28,375,7,0,382,168,550
3032,0,23,3,0,7,38,46,2,0,0,19,198,23,359,12,1,372,176,548
3033,3,65,7,0,5,36,53,2,4,4,23,156,31,389,6,0,395,155,550
3034,2,54,3,0,14,49,67,2,2,3,43,132,39,410,7,0,417,158,575
3035,0,10,0,0,5,18,29,0,0,1,5,25,20,113,2,0,115,45,160
3036,0,15,0,1,0,8,22,1,0,2,6,51,13,119,0,0,119,35,154
3037,2,35,3,1,4,32,46,1,1,3,26,101,39,294,5,4,303,114,417
3038,1,30,2,0,1,33,40,1,1,1,57,94,35,296,4,0,300,113,413
3039,1,46,0,0,0,35,42,3,2,1,17,73,25,245,5,0,250,123,373
3040,2,45,0,1,2,50,27,2,2,1,12,68,16,228,2,1,231,119,350
3043,1,58,0,1,8,30,68,1,1,0,13,176,60,417,3,0,420,180,600
3044,2,56,1,0,3,31,59,6,0,3,21,159,61,402,8,0,410,190,600
3045,1,49,0,0,5,32,53,2,1,2,18,173,49,385,8,3,396,204,600
3046,0,74,0,1,4,32,46,3,1,5,33,155,56,410,4,0,414,186,600
3047,1,52,0,0,2,27,68,1,3,3,33,159,37,386,3,2,391,209,600
3048,1,43,2,1,2,44,60,3,1,4,28,153,38,380,5,0,385,215,600
3049,2,48,5,0,5,40,53,1,2,4,15,143,62,380,1,2,383,217,600
3050,0,66,2,0,6,31,51,1,0,1,20,179,53,410,7,1,418,182,600
3051,3,84,0,2,2,30,52,0,3,3,17,154,54,404,2,0,406,194,600
3052,2,60,3,1,2,22,41,2,1,3,11,160,43,351,6,0,357,193,550
3053,1,71,0,1,3,29,38,5,1,3,24,146,29,351,1,0,352,198,550
3054,2,70,0,1,4,26,47,4,1,1,19,159,64,398,5,0,403,155,558
3055,5,42,1,0,0,34,62,3,0,2,33,161,44,387,4,0,391,209,600
3056,4,49,0,0,1,28,59,4,2,0,24,140,29,340,1,1,342,158,500
3057,1,52,0,0,2,33,59,4,3,2,18,148,41,363,5,1,369,152,521
3058,1,18,1,0,2,17,90,1,1,2,14,235,21,403,6,1,410,207,617
3059,1,47,1,0,6,30,108,5,6,1,41,171,28,445,4,3,452,200,652
3060,2,22,3,0,2,33,80,5,0,0,12,97,24,280,9,0,289,133,422
3066,0,18,0,1,0,15,30,2,0,1,6,126,9,208,3,2,213,142,355
3067,1,31,0,0,1,27,47,2,2,0,26,85,35,257,4,2,263,167,430
3068,0,54,1,0,3,40,57,3,0,1,21,95,18,293,2,1,296,134,430
3069,1,72,1,0,0,27,85,5,0,4,32,136,49,412,13,0,425,175,600
3070,3,83,2,0,7,28,86,2,5,3,23,129,52,423,8,0,431,169,600
3071,2,94,0,2,5,18,56,2,0,0,23,87,51,340,4,1,345,155,500
3072,2,81,0,0,3,27,63,2,2,4,17,116,33,350,4,0,354,146,500
3073,2,79,1,1,2,25,49,3,0,2,12,138,45,359,8,1,368,132,500
3074,0,74,0,1,3,27,71,3,1,1,21,113,50,365,9,1,375,125,500
3075,1,95,1,0,1,27,74,4,2,0,22,98,44,369,4,1,374,147,521
3076,0,61,1,0,5,22,30,6,1,2,5,112,30,275,3,0,278,122,400
3077,2,50,0,0,1,26,51,9,2,0,23,95,27,286,2,1,289,108,397
3078,2,36,0,0,4,26,56,1,4,2,54,143,36,364,6,0,370,130,500
3079,0,41,1,1,1,33,50,1,2,1,60,138,44,373,8,1,382,89,471
3080,0,73,2,2,3,53,63,8,3,4,22,98,83,414,5,1,420,180,600
3086,2,53,2,0,1,23,54,3,1,2,21,82,71,315,4,0,319,181,500
3087,1,39,2,1,0,24,66,6,3,2,17,78,82,321,6,1,328,172,500
3088,2,37,1,0,2,26,49,6,5,0,24,111,38,301,8,1,310,190,500
3089,2,66,1,1,6,35,50,2,2,3,31,80,106,385,3,2,390,191,581
3090,1,93,1,0,2,49,65,19,2,1,23,87,33,376,8,2,386,214,600
3091,2,87,1,1,2,57,60,9,1,1,33,87,38,379,8,0,387,235,622
3092,1,45,3,0,4,28,113,4,1,2,20,79,43,343,2,3,348,263,611
3093,1,19,1,0,1,23,28,7,0,0,10,96,40,226,4,0,230,85,315
3094,1,15,0,0,0,6,36,4,0,2,2,57,15,138,10,2,150,132,282
3095,2,40,1,1,2,36,82,1,2,2,28,82,24,303,4,1,308,142,450
3096,2,30,2,0,2,36,73,4,1,3,22,93,38,306,6,1,313,137,450
3097,3,23,1,1,2,37,77,6,3,4,47,79,41,324,0,0,324,112,436
3098,1,21,0,3,0,11,40,6,0,1,10,22,45,160,1,0,161,45,206
3099,1,47,0,0,3,39,47,2,3,0,23,170,45,380,5,0,385,215,600
3100,1,55,3,0,4,52,42,2,1,3,21,167,45,396,0,0,396,204,600
3101,0,61,1,0,2,41,28,6,2,2,19,189,40,391,5,1,397,203,600
3102,1,67,1,1,2,42,44,2,1,0,11,137,43,352,6,1,359,241,600
3103,0,57,0,0,2,35,46,8,2,0,21,177,39,387,1,2,390,210,600
3104,1,61,2,0,2,43,44,7,1,1,18,168,39,387,3,0,390,210,600
3105,1,80,0,1,2,49,46,0,1,0,16,126,57,379,8,0,387,213,600
3106,0,66,3,1,2,55,39,1,4,2,23,144,54,394,2,0,396,189,585
3107,0,68,1,3,2,49,81,9,0,2,20,123,33,391,7,0,398,177,575
3108,0,62,2,2,1,26,76,9,3,3,16,127,41,368,2,1,371,187,558
3109,0,16,2,0,0,9,13,0,1,0,3,31,9,84,0,0,84,38,122
3110,1,12,0,0,0,8,21,1,0,1,1,25,11,81,2,0,83,30,113
3111,0,57,1,0,3,36,56,4,2,3,16,122,49,349,9,1,359,241,600
3112,1,46,2,0,3,50,45,7,3,0,29,128,57,371,6,2,379,221,600
3113,1,58,1,0,2,41,34,2,0,0,18,160,48,365,8,2,375,225,600
3114,5,66,0,1,5,53,55,5,1,2,24,154,35,406,4,4,414,220,634
3115,0,39,2,1,5,33,51,6,1,0,11,140,39,328,4,0,332,168,500
3116,1,42,1,0,2,38,59,1,2,1,13,153,32,345,4,0,349,158,507
3117,2,66,2,0,0,27,74,9,11,4,21,132,40,388,5,1,394,156,550
3118,2,44,2,1,4,34,81,3,8,2,13,135,27,356,3,1,360,190,550
3119,1,47,2,0,3,33,61,5,2,4,22,113,30,323,2,1,326,130,456
3120,1,53,0,1,4,18,40,2,3,2,14,134,42,314,7,3,324,126,450
3121,2,62,0,0,3,30,30,0,0,0,15,137,33,312,12,0,324,127,451
3122,1,46,1,1,6,39,72,6,0,2,25,147,30,376,5,2,383,167,550
3123,4,47,1,0,4,45,48,8,5,3,19,147,32,363,9,2,374,176,550
3124,2,65,2,1,5,42,56,8,0,0,27,154,21,383,1,2,386,144,530
3125,0,12,1,1,1,8,16,0,0,2,0,54,6,101,0,1,102,31,133
3126,0,66,3,0,12,26,93,0,3,1,7,136,60,407,5,0,412,138,550
3127,1,65,0,2,7,29,82,1,3,1,19,146,46,402,1,1,404,113,517
3128,1,37,2,0,2,24,62,5,1,2,13,151,34,334,2,1,337,113,450
3129,1,35,1,1,2,23,74,3,1,0,14,148,37,340,1,0,341,109,450
3130,1,34,3,0,1,11,61,1,1,0,10,126,30,279,2,1,282,111,393
3131,0,37,1,0,0,15,40,3,0,4,8,89,56,253,2,1,256,109,365
3132,0,51,1,0,2,21,44,3,6,0,10,80,55,273,4,1,278,87,365
3133,1,12,1,0,0,1,21,2,0,2,7,69,5,121,1,1,123,132,255
3134,1,7,0,0,1,4,17,3,0,1,2,58,5,99,1,0,100,154,254
3135,2,25,0,4,0,18,50,4,2,2,7,147,30,291,2,0,293,92,385
3136,1,14,0,2,4,19,52,4,0,2,9,151,31,289,5,1,295,85,380
3137,2,21,1,0,0,11,40,1,0,1,25,77,23,202,3,2,207,148,355
3138,0,25,0,0,0,16,36,3,1,1,16,105,24,227,2,2,231,127,358
3139,0,60,0,0,1,27,31,3,0,1,13,68,38,242,1,2,245,134,379
3140,2,33,2,0,1,26,76,5,1,3,16,123,41,329,4,2,335,165,500
3141,2,41,0,0,2,24,59,1,0,0,17,131,42,319,5,0,324,176,500
3142,1,18,1,1,2,24,62,3,0,1,16,121,34,284,10,0,294,206,500
3143,3,31,0,0,7,45,95,3,1,0,19,124,34,362,9,0,371,195,566
3144,0,19,0,0,0,4,22,1,0,0,0,34,10,90,1,2,93,76,169
3145,0,29,0,2,2,20,47,3,4,1,9,55,22,194,1,0,195,56,251
3146,1,14,0,0,4,69,132,1,1,3,33,27,16,301,4,0,305,94,399
3147,0,4,0,0,0,13,24,2,0,0,3,61,15,122,2,1,125,103,228
3148,0,29,0,0,0,12,34,4,0,2,7,35,24,147,2,1,150,80,230
3149,1,27,3,0,1,132,74,4,1,2,5,80,18,348,9,2,359,270,629
3150,0,18,0,1,3,31,7,1,0,1,4,35,2,103,0,0,103,53,156
3151,0,18,2,0,2,17,40,2,2,1,12,96,56,248,7,2,257,181,438
3152,0,13,2,0,0,8,24,1,0,6,0,53,12,119,0,0,119,68,187
3153,0,2,2,0,0,5,14,0,0,0,13,53,8,97,1,0,98,56,154
3154,2,67,0,0,2,26,58,5,0,1,19,136,28,344,5,0,349,201,550
3155,0,90,1,0,4,27,54,3,1,1,16,131,32,360,1,2,363,137,500
3156,0,114,3,1,4,15,51,3,2,0,29,97,44,363,0,0,363,182,545
3157,0,5,1,0,0,2,15,0,0,0,1,25,4,53,0,0,53,26,79
3158,1,14,0,0,2,10,29,2,0,3,7,73,10,151,4,1,156,109,265
3159,0,10,0,0,0,3,15,3,0,0,1,46,27,105,2,0,107,47,154
3160,1,13,0,0,0,10,13,7,0,2,7,19,11,83,1,1,85,22,107
3161,3,40,2,2,3,36,59,8,4,3,31,90,36,317,4,2,323,174,497
3162,0,27,3,0,5,28,80,6,0,3,11,85,8,256,6,1,263,144,407
3163,1,13,1,0,3,24,51,8,2,6,2,24,15,150,4,0,154,144,298
3164,3,39,1,2,2,55,69,6,0,4,19,156,33,389,4,0,393,207,600
3165,4,44,2,1,5,29,82,4,1,2,21,141,30,366,5,2,373,227,600
3166,1,47,0,0,2,29,68,7,0,3,11,147,22,337,4,0,341,259,600
3167,2,45,0,1,4,30,56,3,1,2,15,166,34,359,5,2,366,234,600
3168,1,28,3,1,1,33,47,2,0,1,12,143,22,294,1,0,295,205,500
3169,0,36,1,1,1,44,54,1,1,2,13,128,28,310,4,2,316,184,500
3170,0,42,0,2,5,33,74,2,1,1,15,119,23,317,4,1,322,178,500
3171,1,46,1,0,4,48,83,2,2,2,24,144,18,375,11,1,387,170,557
3172,0,2,0,0,0,1,18,1,0,0,2,22,13,59,0,0,59,38,97
3173,1,28,1,1,2,17,51,6,0,0,6,43,10,166,0,1,167,81,248
3174,1,35,1,0,1,18,59,8,2,0,26,122,18,291,3,0,294,124,418
3175,1,6,1,0,0,11,29,2,0,2,10,56,5,123,1,0,124,51,175
3176,2,13,0,1,1,15,45,2,0,2,7,20,14,122,0,2,124,96,220
3177,0,9,1,0,0,13,29,3,0,0,3,22,15,95,1,1,97,97,194
3178,3,34,0,0,4,33,61,8,1,0,21,122,18,305,3,1,309,140,449
3179,0,12,0,0,1,24,29,5,0,0,3,23,12,109,1,0,110,149,259
3180,0,34,0,3,0,20,30,7,1,1,16,85,25,222,6,0,228,130,358
3181,1,2,1,0,0,4,10,1,0,0,3,26,8,56,0,1,57,37,94
3182,1,141,0,1,0,27,87,1,5,2,30,68,110,473,5,0,478,122,600
3183,0,114,1,3,5,26,118,2,0,1,18,66,118,472,5,1,478,122,600
3184,1,114,3,1,3,29,78,3,2,1,18,56,62,371,2,0,373,127,500
3185,0,110,2,0,5,30,79,2,3,2,11,60,75,379,3,2,384,116,500
3186,0,106,2,2,0,27,81,0,5,3,27,52,91,396,4,0,400,100,500
3187,0,96,0,4,1,24,83,3,2,0,18,47,122,400,1,0,401,99,500
3188,1,106,1,0,3,28,70,2,5,3,25,53,92,389,3,2,394,107,501
3189,0,1,0,1,0,2,18,1,0,0,0,2,10,35,0,0,35,16,51
3190,0,80,1,0,2,31,89,4,5,2,31,82,132,459,2,3,464,136,600
3191,1,58,1,2,1,27,142,2,3,2,20,51,129,439,5,2,446,115,561
3192,2,69,2,1,2,12,119,3,1,4,25,54,71,365,1,2,368,82,450
3193,0,85,1,1,7,14,109,2,2,2,20,47,122,412,0,1,413,64,477
3194,0,9,0,1,0,6,19,3,0,0,11,5,27,81,1,0,82,49,131
3195,0,62,1,0,1,13,39,2,2,1,18,30,72,241,5,1,247,69,316
3196,0,7,0,0,0,3,23,0,0,0,7,3,15,58,0,0,58,5,63
3197,0,61,0,1,0,19,143,6,2,0,19,43,97,391,6,0,397,129,526
3198,4,58,1,1,0,14,128,3,5,1,21,36,69,341,2,1,344,96,440
3199,1,58,0,0,2,10,78,2,0,0,16,25,34,226,2,4,232,52,284
3200,0,27,0,0,0,10,44,1,1,1,7,12,22,125,0,1,126,27,153
3201,0,81,2,0,0,14,153,2,1,1,29,38,61,382,2,0,384,95,479
3202,0,117,1,2,6,15,122,0,1,1,20,39,81,405,2,1,408,71,479
3203,1,58,1,0,1,9,97,2,0,2,19,30,48,268,3,0,271,74,345
3204,0,101,0,2,7,41,68,3,2,2,25,104,77,432,0,0,432,168,600
3205,0,78,0,2,3,30,69,4,3,0,28,111,71,399,2,0,401,199,600
3206,1,63,1,0,1,36,63,5,3,2,26,89,78,368,2,2,372,228,600
3207,0,87,1,0,2,32,58,11,3,3,23,114,78,412,4,0,416,184,600
3208,1,94,2,1,3,35,60,8,5,2,21,105,55,392,5,2,399,201,600
3209,0,90,2,1,3,29,52,5,5,2,18,119,72,398,2,0,400,200,600
3210,0,99,1,1,6,45,63,3,2,1,29,78,92,420,3,0,423,177,600
3211,2,76,1,0,2,24,46,6,1,0,23,95,91,367,4,0,371,229,600
3212,1,76,2,2,3,23,69,8,0,1,14,84,63,346,3,3,352,178,530
3213,3,3,0,1,0,4,34,1,0,0,2,29,12,89,1,0,90,58,148
3214,0,28,0,0,0,31,69,3,0,0,9,44,70,254,0,1,255,158,413
3215,1,32,1,0,0,21,45,7,2,0,23,36,83,251,5,0,256,144,400
3216,2,71,2,2,5,31,61,3,2,0,19,123,81,402,2,2,406,194,600
3217,1,92,3,1,1,35,67,4,6,0,23,88,71,392,4,0,396,204,600
3218,1,92,1,2,0,35,36,6,3,0,19,93,96,384,5,0,389,211,600
3219,1,63,1,1,8,32,48,2,3,3,20,96,55,333,1,0,334,216,550
3220,1,69,1,0,1,41,40,5,4,1,20,89,70,342,2,3,347,203,550
3221,1,85,1,1,1,41,50,7,1,3,18,101,50,360,5,0,365,185,550
3222,0,51,0,0,2,33,47,2,2,1,18,82,70,308,5,1,314,186,500
3223,2,72,1,2,2,40,40,2,1,3,15,102,59,341,2,0,343,205,548
3224,1,15,1,1,0,15,22,2,1,1,31,28,19,137,0,0,137,42,179
3225,2,53,3,1,1,38,87,6,3,1,25,81,58,359,4,0,363,137,500
3226,1,48,0,0,3,31,56,2,0,0,48,73,81,343,1,2,346,154,500
3227,4,50,1,0,5,43,68,5,0,4,22,74,62,338,4,0,342,134,476
3228,0,33,1,1,5,23,54,1,0,3,27,81,47,276,4,0,280,120,400
3229,0,48,1,0,2,19,36,1,0,0,19,82,40,248,3,0,251,122,373
3230,1,77,0,0,3,28,60,5,4,1,28,89,69,365,2,1,368,182,550
3231,1,88,2,3,6,36,72,6,4,1,21,61,76,377,2,0,379,125,504
3232,2,43,0,0,2,43,54,3,1,3,19,47,56,273,6,1,280,117,397
3233,0,31,1,3,1,19,70,5,0,4,9,140,46,329,2,1,332,268,600
3234,1,52,0,0,2,26,63,0,2,2,12,130,61,351,8,0,359,241,600
3235,0,37,0,2,1,21,59,3,2,2,11,142,42,322,2,0,324,276,600
3236,1,43,1,1,1,21,55,2,2,2,9,133,39,310,8,1,319,281,600
3237,1,42,1,1,3,36,62,4,0,1,10,125,55,341,3,2,346,254,600
3238,0,41,0,1,3,26,50,4,0,0,16,135,45,321,4,1,326,274,600
3239,1,47,0,0,0,19,43,0,2,2,9,110,51,284,4,1,289,211,500
3240,1,52,0,0,1,22,46,2,3,1,10,116,57,311,3,0,314,186,500
3241,1,52,0,1,3,27,35,1,2,2,10,114,38,286,0,1,287,216,503
3242,4,41,3,1,4,24,67,5,1,2,12,136,34,334,10,1,345,230,575
3243,0,21,1,1,1,24,69,8,0,0,17,154,21,317,11,0,328,247,575
3244,1,28,0,1,0,19,77,4,3,2,8,151,18,312,4,7,323,250,573
3245,0,14,1,1,1,20,56,0,0,1,13,142,9,258,2,0,260,128,388
3246,0,4,2,0,0,7,44,3,1,0,14,101,11,187,0,1,188,96,284
3247,0,28,1,1,0,11,56,3,0,1,4,87,32,224,3,1,228,209,437
3248,3,15,3,2,1,21,30,5,0,0,1,52,22,155,7,1,163,120,283
3249,1,22,1,1,3,21,54,4,0,3,4,113,14,241,6,3,250,150,400
3250,2,28,0,0,1,30,63,4,0,3,5,90,18,244,7,2,253,153,406
3251,0,15,0,0,0,6,44,0,0,0,2,38,10,115,2,0,117,60,177
3252,0,25,0,2,1,13,61,1,0,0,5,89,35,232,6,0,238,211,449
3253,0,18,0,0,1,14,15,1,4,0,5,53,8,119,2,0,121,76,197
3254,1,22,1,0,2,26,39,2,0,2,3,106,17,221,4,0,225,175,400
3255,4,29,1,1,2,26,49,1,2,1,9,74,13,212,5,3,220,150,370
3256,0,2,0,0,0,0,28,0,0,2,3,57,4,96,1,2,99,60,159
3257,2,22,2,1,2,16,62,8,2,1,4,96,12,230,2,2,234,139,373
3258,0,6,1,0,0,19,51,3,4,0,2,72,14,172,3,0,175,127,302
3259,1,15,8,0,0,0,33,2,1,1,2,68,23,154,9,1,164,109,273
3260,2,21,1,1,1,15,53,5,0,3,10,78,51,241,5,4,250,350,600
3261,2,17,2,2,2,12,39,6,1,2,5,66,29,185,3,1,189,311,500
3262,1,24,0,0,1,9,45,4,0,0,16,94,36,230,4,2,236,264,500
3263,3,17,0,0,0,11,58,2,0,2,13,59,25,190,9,0,199,301,500
3264,0,12,0,1,0,10,35,2,0,1,8,86,22,177,9,3,189,312,501
3265,1,20,1,0,15,10,58,6,3,3,3,56,22,198,5,4,207,193,400
3266,0,12,1,1,7,7,36,5,0,1,3,56,23,152,7,2,161,188,349
3267,0,5,0,0,0,0,14,0,2,1,1,33,8,64,1,0,65,53,118
3268,0,9,2,0,1,5,12,3,3,3,3,71,13,125,4,0,129,131,260
3269,0,13,1,1,1,12,26,1,0,4,3,78,13,153,6,1,160,123,283
3270,1,11,1,0,3,7,64,2,1,2,4,61,26,183,6,1,190,188,378
3271,1,55,0,0,3,22,52,5,1,1,9,188,47,384,12,3,399,201,600
3272,2,63,1,0,3,17,52,4,1,1,9,196,35,384,0,0,384,216,600
3273,1,55,0,1,6,14,56,1,1,0,18,184,38,375,7,0,382,218,600
3274,1,65,1,0,1,15,43,0,2,0,18,148,43,337,4,3,344,175,519
3275,1,7,1,0,1,7,35,2,0,1,2,65,12,134,0,0,134,79,213
3276,0,6,0,1,1,10,21,0,0,1,10,62,7,119,2,0,121,68,189
3277,0,15,0,1,2,5,35,0,0,1,1,33,10,103,6,1,110,76,186
3278,0,25,0,0,0,14,51,3,1,0,7,81,12,194,4,2,200,122,322
3279,0,20,0,1,0,9,37,4,0,1,4,61,25,162,6,1,169,181,350
3280,0,17,1,0,0,9,39,3,0,1,4,45,24,143,4,1,148,174,322
3281,0,90,1,0,0,6,49,0,0,0,8,90,21,265,2,2,269,249,518
3282,1,18,0,5,3,20,57,4,1,2,7,78,36,232,7,3,242,314,556
3283,0,23,1,0,0,25,73,2,1,1,19,129,59,333,8,0,341,157,498
3284,3,19,0,2,3,10,50,3,1,1,7,51,22,172,2,4,178,187,365
3285,1,15,0,0,1,13,58,4,0,1,1,50,27,171,5,0,176,174,350
3286,0,8,0,2,7,5,56,3,2,3,1,89,21,197,4,1,202,273,475
3287,2,5,0,0,5,0,39,3,0,2,7,53,35,151,2,0,153,123,276
3288,0,10,0,0,2,5,29,0,0,0,4,58,28,136,1,1,138,262,400
3289,0,13,2,0,1,29,41,2,0,0,5,59,34,186,1,1,188,212,400
3290,0,9,1,0,0,8,41,4,0,4,9,59,21,156,6,2,164,168,332
3291,0,20,1,0,1,13,76,3,0,0,9,55,31,209,2,1,212,188,400
3292,2,20,0,0,0,10,62,5,0,1,3,50,41,194,4,2,200,136,336
3293,15,0,0,0,0,31,30,4,1,1,7,41,35,165,5,1,171,123,294
3294,0,23,0,1,1,23,109,5,1,0,11,97,15,286,5,2,293,134,427
3295,1,33,1,1,1,23,55,1,4,5,3,108,47,283,6,2,291,209,500
3296,0,16,1,0,2,21,39,3,0,5,7,141,26,261,7,0,268,232,500
3297,2,19,1,1,3,28,50,7,2,3,12,107,31,266,4,1,271,229,500
3298,1,27,0,2,1,23,44,5,2,2,9,105,35,256,10,0,266,212,478
3299,0,3,1,0,0,1,11,0,0,0,0,17,2,35,0,0,35,19,54
3300,1,21,0,0,11,19,41,1,0,0,14,60,43,211,3,0,214,196,410
3301,0,13,0,0,3,5,55,0,1,0,11,69,21,178,4,0,182,87,269
3302,2,42,3,0,0,61,60,3,1,1,13,96,45,327,8,0,335,265,600
3303,0,47,4,1,8,48,59,1,2,2,22,83,31,308,4,1,313,287,600
3304,1,51,0,1,2,36,68,3,2,0,18,95,37,314,2,1,317,283,600
3305,0,37,1,1,2,39,56,2,0,1,19,45,37,240,3,0,243,257,500
3306,0,39,0,2,2,31,66,4,2,3,28,67,38,282,2,0,284,216,500
3307,0,38,3,0,8,43,47,2,1,1,10,119,43,315,4,1,320,255,575
3308,0,5,0,0,0,4,3,0,0,1,1,26,5,45,1,0,46,31,77
3309,0,11,2,11,3,22,26,2,1,2,9,42,54,185,6,2,193,181,374
3310,2,8,0,0,1,4,25,3,0,0,3,27,21,94,0,0,94,121,215
3311,0,2,1,0,1,5,9,1,0,0,1,12,14,46,0,0,46,89,135
3312,1,20,3,16,2,22,49,3,0,3,14,97,33,263,4,1,268,338,606
3313,1,31,0,6,1,46,47,3,2,0,13,107,33,290,9,0,299,301,600
3314,1,44,0,6,3,49,33,0,1,2,13,74,39,265,3,2,270,263,533
3315,1,10,0,0,1,19,14,1,2,2,3,75,19,147,3,0,150,177,327
3316,0,17,1,2,1,27,5,2,1,1,0,69,11,137,6,0,143,116,259
3317,1,18,0,2,1,17,28,0,0,0,3,74,42,186,2,1,189,156,345
3318,0,19,0,1,2,25,28,0,0,1,3,65,32,176,3,2,181,164,345
3319,1,10,2,0,2,24,39,4,0,2,6,59,81,230,5,0,235,135,370
3320,0,15,0,0,1,14,56,2,0,1,7,44,28,168,6,1,175,160,335
3321,1,19,0,0,2,16,40,3,0,0,7,52,25,165,1,0,166,172,338
3322,0,38,2,0,3,10,8,0,0,1,13,16,21,112,0,1,113,67,180
3323,2,11,0,0,5,15,26,2,0,0,1,33,14,109,2,0,111,102,213
3324,2,51,0,1,18,44,28,4,3,5,22,131,44,353,8,0,361,239,600
3325,3,47,1,0,14,44,43,1,1,10,12,109,41,326,6,1,333,267,600
3326,2,46,0,1,8,29,37,6,2,5,10,114,39,299,5,0,304,248,552
3327,0,6,0,0,0,2,6,1,0,0,2,32,6,55,0,0,55,60,115
3328,0,7,0,0,1,12,9,1,0,0,4,53,1,88,1,0,89,128,217
3329,2,14,0,0,3,24,33,4,1,1,9,49,34,174,4,1,179,115,294
3330,2,57,0,1,5,43,37,3,1,4,13,111,46,323,5,1,329,230,559
3331,0,21,0,2,3,29,48,0,0,2,4,103,32,244,3,1,248,179,427
3332,1,10,1,0,0,20,16,2,0,0,4,24,30,108,2,0,110,51,161
3333,0,27,0,0,0,22,66,5,1,1,26,121,37,306,4,2,312,288,600
3334,4,21,2,0,0,17,94,4,1,1,28,135,38,345,5,2,352,248,600
3335,1,22,1,0,3,23,71,4,3,2,18,139,42,329,3,1,333,267,600
3336,0,30,2,1,3,24,62,2,0,1,19,100,29,273,3,2,278,222,500
3337,0,14,0,0,1,20,69,7,1,1,9,125,41,288,1,0,289,211,500
3338,1,38,2,1,1,16,47,2,2,1,24,104,49,288,1,1,290,213,503
3339,0,11,0,0,0,0,17,0,0,0,3,13,22,66,1,0,67,68,135
3340,2,29,0,0,5,11,33,2,0,0,20,153,38,293,5,1,299,149,448
3341,0,10,0,0,0,4,52,4,3,2,13,43,71,202,9,0,211,120,331
3342,2,23,0,1,0,6,63,2,2,1,6,60,16,182,4,0,186,181,367
3343,0,4,0,1,1,9,48,0,1,1,11,140,14,230,1,3,234,91,325
3344,0,15,1,0,2,11,69,2,0,2,14,77,17,210,7,2,219,148,367
3345,0,3,0,0,2,0,5,1,0,1,3,20,5,40,1,0,41,5,46
3346,1,11,1,0,0,9,80,3,1,1,8,73,34,222,5,1,228,148,376
3347,1,9,2,1,1,15,83,0,3,1,33,67,64,280,5,0,285,213,498
3348,0,22,0,0,4,22,32,0,2,0,10,120,9,221,5,0,226,132,358
3349,1,5,1,0,1,13,17,0,0,0,0,40,12,90,3,0,93,48,141
3350,1,28,1,0,3,15,122,13,3,1,14,74,52,327,2,2,331,197,528
3351,1,10,1,0,2,22,66,4,1,0,27,160,28,322,4,0,326,224,550
3352,0,6,2,0,4,15,59,2,1,2,11,185,28,315,5,2,322,178,500
3353,0,11,0,1,0,23,67,5,1,0,18,158,13,297,10,1,308,192,500
3354,1,15,1,2,1,32,61,5,3,0,28,154,36,339,6,1,346,199,545
3355,0,9,2,0,0,7,60,0,1,2,18,96,21,216,6,3,225,175,400
3356,1,6,1,0,1,18,44,0,2,1,13,98,12,197,1,0,198,112,310
3357,0,13,0,1,0,16,72,5,0,0,28,156,17,308,8,2,318,182,500
3358,0,12,1,0,0,22,85,5,0,1,26,108,14,274,6,0,280,162,442
3359,2,135,15,0,4,50,105,3,4,0,17,28,98,461,4,0,465,135,600
3360,0,147,10,0,2,41,107,5,5,1,17,32,97,464,5,1,470,130,600
3361,0,156,6,0,1,58,107,3,0,1,16,41,81,470,2,0,472,128,600
3362,0,126,13,1,8,48,95,1,1,2,25,39,92,451,7,0,458,142,600
3363,0,160,10,0,4,42,107,1,8,1,13,41,75,462,5,1,468,132,600
3364,0,153,9,1,2,47,95,3,6,3,20,28,97,464,1,0,465,136,601
3365,1,158,7,1,7,44,106,2,6,0,10,30,94,466,3,0,469,131,600
3366,0,137,12,0,2,51,114,2,3,1,11,29,104,466,5,1,472,128,600
3367,0,156,8,1,2,55,83,5,6,1,24,34,86,461,5,0,466,134,600
3368,1,159,3,0,4,45,105,3,3,1,20,33,100,477,1,0,478,122,600
3369,1,140,5,0,2,52,112,2,3,2,14,26,97,456,1,0,457,143,600
3370,0,135,8,1,4,55,105,4,1,1,22,37,89,462,4,0,466,134,600
3371,0,135,7,1,4,50,99,2,2,2,21,33,123,479,2,0,481,119,600
3372,2,141,4,0,1,50,154,1,5,2,10,20,101,491,3,0,494,106,600
3373,0,152,14,0,2,59,102,2,2,1,19,32,99,484,2,0,486,114,600
3374,2,142,16,0,3,61,95,5,5,2,12,30,77,450,2,1,453,147,600
3375,0,137,12,0,3,39,99,3,1,2,24,34,120,474,4,0,478,122,600
3376,0,125,8,1,3,57,108,0,2,4,12,47,100,467,2,2,471,129,600
3377,0,182,12,0,3,43,76,2,0,1,22,36,85,462,5,1,468,132,600
3378,1,120,1,0,1,42,84,3,3,1,18,23,90,387,0,1,388,112,500
3379,0,113,11,0,1,46,102,1,0,1,25,28,74,402,1,1,404,96,500
3380,0,139,7,1,4,37,60,5,0,1,23,35,68,380,2,0,382,118,500
3381,1,154,11,1,1,42,93,1,2,0,18,26,83,433,0,0,433,151,584
3382,0,144,10,0,2,51,120,2,7,4,19,25,91,475,2,2,479,121,600
3383,1,133,9,0,2,46,111,6,1,0,11,42,74,436,1,0,437,163,600
3384,0,142,14,2,0,54,89,4,5,2,20,55,98,485,3,0,488,112,600
3385,1,136,13,1,2,42,102,1,14,0,13,39,95,459,5,0,464,136,600
3386,0,165,7,0,1,32,98,4,2,0,25,37,99,470,6,0,476,124,600
3387,0,156,10,0,5,37,128,7,7,1,17,20,86,474,5,0,479,121,600
3388,0,156,11,0,2,48,114,2,3,1,14,30,83,464,0,2,466,134,600
3389,2,154,9,1,5,39,106,3,6,3,13,36,86,463,3,1,467,133,600
3390,0,145,9,3,3,34,109,7,3,2,18,40,92,465,3,0,468,132,600
3391,2,153,11,1,2,38,103,3,4,2,19,34,104,476,2,0,478,122,600
3392,0,159,11,0,1,38,102,4,1,3,25,36,104,484,2,0,486,114,600
3393,2,140,6,0,3,43,119,4,5,1,11,43,96,473,3,0,476,124,600
3394,0,130,12,2,3,29,79,0,4,2,17,40,59,377,5,1,383,117,500
3395,0,120,4,0,3,26,100,4,4,2,16,40,71,390,0,2,392,108,500
3396,1,119,13,0,3,34,83,1,2,1,14,47,55,373,3,0,376,124,500
3397,0,103,11,1,6,38,105,4,5,2,15,34,78,402,5,1,408,92,500
3398,1,116,3,2,0,34,110,4,4,2,11,45,77,409,3,0,412,150,562
3399,0,2,0,0,1,3,21,1,1,0,3,1,16,49,1,0,50,54,104
3400,4,129,14,2,4,61,94,2,6,2,28,28,68,442,1,0,443,157,600
3401,4,121,17,1,3,42,82,4,2,5,24,46,63,414,2,0,416,184,600
3402,1,127,16,1,5,60,85,10,2,4,20,52,63,446,5,2,453,147,600
3403,4,142,15,1,4,41,92,3,6,1,30,40,74,453,2,0,455,145,600
3404,1,146,23,0,3,41,98,7,1,1,24,32,67,444,4,1,449,151,600
3405,3,126,7,0,3,40,87,5,6,3,33,42,61,416,3,0,419,181,600
3406,3,122,12,1,3,39,101,7,2,0,14,31,82,417,3,3,423,177,600
3407,2,120,13,1,0,32,101,3,11,1,20,33,51,388,5,1,394,106,500
3408,3,124,14,0,4,40,63,3,7,2,23,40,50,373,6,1,380,120,500
3409,1,110,26,1,3,32,72,4,3,4,14,44,45,359,2,2,363,137,500
3410,3,115,11,0,5,39,79,2,1,3,22,37,56,373,3,2,378,122,500
3411,2,104,15,1,2,35,83,4,4,4,18,33,34,339,9,1,349,151,500
3412,2,119,15,1,4,48,118,2,6,3,15,40,57,430,5,2,437,158,595
3413,3,139,12,1,5,52,76,7,4,3,26,37,65,430,6,0,436,164,600
3414,0,129,10,2,5,55,102,1,3,4,37,44,83,475,5,0,480,120,600
3415,3,137,10,1,4,61,69,1,1,3,28,41,87,446,2,0,448,152,600
3416,3,152,15,0,4,40,69,5,5,2,21,44,78,438,5,0,443,157,600
3417,0,129,9,1,11,49,89,4,7,4,36,59,67,465,8,1,474,126,600
3418,1,144,9,0,4,47,94,2,2,3,34,46,73,459,4,0,463,137,600
3419,0,159,14,0,5,54,56,5,6,3,18,43,65,428,11,0,439,161,600
3420,1,137,9,3,3,48,82,7,5,4,28,41,58,426,6,0,432,168,600
3421,0,136,14,1,5,41,101,8,5,4,24,58,56,453,4,0,457,143,600
3422,1,142,9,1,1,46,117,7,9,3,21,44,82,483,7,0,490,145,635
3423,2,114,15,1,3,41,88,5,9,5,40,52,51,426,8,0,434,166,600
3424,0,139,8,3,2,46,108,3,9,3,24,45,52,442,7,0,449,151,600
3425,1,141,5,2,4,37,81,8,4,3,30,52,63,431,4,0,435,165,600
3426,1,136,20,1,1,42,83,5,4,5,33,44,57,432,1,1,434,166,600
3427,0,118,9,0,3,37,121,2,9,4,32,55,59,449,4,1,454,146,600
3428,1,120,4,0,6,59,78,9,7,6,44,57,68,459,3,0,462,138,600
3429,0,130,5,1,4,48,102,8,4,3,35,37,70,447,3,0,450,150,600
3430,0,129,8,2,6,33,104,6,8,5,16,69,64,450,2,1,453,147,600
3431,1,113,9,1,4,49,112,4,1,2,38,46,70,450,3,0,453,147,600
3432,2,113,8,1,1,30,95,1,7,4,23,52,59,396,0,1,397,153,550
3433,1,111,7,1,3,35,73,8,5,4,32,53,49,382,6,1,389,140,529
3434,1,88,11,0,6,49,88,8,5,3,24,55,47,385,5,0,390,210,600
3435,0,97,20,1,2,54,86,3,4,3,37,48,50,405,6,0,411,189,600
3436,1,92,10,0,3,50,120,3,2,2,20,47,56,406,5,1,412,188,600
3437,1,90,6,2,2,55,89,1,6,4,28,42,49,375,5,2,382,159,541
3438,3,103,23,0,3,37,62,7,4,4,21,50,42,359,5,1,365,135,500
3439,3,78,12,0,5,35,64,3,4,5,30,55,32,326,2,2,330,170,500
3440,5,68,15,1,1,54,68,5,4,1,21,52,44,339,4,1,344,156,500
3441,1,68,15,0,0,43,83,6,2,1,19,58,46,342,3,0,345,155,500
3442,0,97,12,0,2,49,57,5,2,2,16,73,49,364,8,0,372,128,500
3443,0,111,26,0,5,30,72,5,1,1,29,67,34,381,6,0,387,165,552
3444,3,100,29,1,2,36,67,10,8,5,27,82,45,415,8,0,423,177,600
3445,3,75,24,2,1,44,100,3,2,3,25,102,48,432,2,1,435,165,600
3446,1,97,23,0,1,36,67,5,3,4,22,129,40,428,5,1,434,166,600
3447,0,90,15,1,1,32,74,3,3,4,20,73,40,356,6,0,362,138,500
3448,2,89,12,0,3,36,65,4,4,4,19,88,35,361,3,0,364,136,500
3449,0,67,18,0,2,32,114,5,5,4,13,62,35,357,5,1,363,137,500
3450,1,72,13,0,3,41,66,4,2,2,20,85,51,360,1,1,362,138,500
3451,2,79,28,0,2,48,60,6,6,5,21,74,51,382,8,0,390,151,541
3452,0,107,18,1,3,56,98,6,4,3,33,53,47,429,10,0,439,161,600
3453,3,113,11,0,2,37,77,3,3,6,29,49,28,361,6,2,369,131,500
3454,1,75,15,3,0,37,109,7,2,5,30,52,38,374,4,0,378,122,500
3455,0,102,11,1,1,54,70,5,0,1,27,42,35,349,8,1,358,142,500
3456,2,98,22,0,0,39,75,6,4,2,32,75,41,396,6,1,403,169,572
3457,1,122,18,0,4,52,70,3,6,5,29,56,78,444,11,0,455,145,600
3458,2,112,18,0,3,48,79,7,6,6,31,52,84,448,6,2,456,144,600
3459,4,127,29,2,4,37,90,5,4,1,34,65,58,460,7,0,467,133,600
3460,1,110,36,0,4,48,69,9,4,6,27,63,68,445,4,1,450,150,600
3461,0,121,29,1,0,49,77,3,7,2,26,71,84,470,11,1,482,118,600
3462,1,114,27,2,7,46,91,2,3,7,23,58,79,460,8,2,470,130,600
3463,3,120,16,1,2,45,81,7,4,3,21,73,75,451,10,1,462,138,600
3464,1,127,32,0,1,43,88,4,11,3,26,54,74,464,5,0,469,131,600
3465,1,130,30,2,2,34,70,4,4,8,25,60,85,455,2,0,457,143,600
3466,0,120,15,0,4,43,101,3,2,3,35,56,93,475,7,0,482,118,600
3467,0,95,30,1,1,56,83,8,2,8,17,87,73,461,4,2,467,133,600
3468,0,136,22,3,3,42,66,6,2,2,32,73,65,452,5,1,458,142,600
3469,0,105,31,0,1,72,63,3,4,2,28,70,63,442,3,0,445,155,600
3470,1,143,24,1,3,52,84,3,4,8,29,56,66,474,9,0,483,163,646
3471,3,103,29,1,6,48,79,8,4,2,48,41,50,422,22,0,444,156,600
3472,2,91,6,1,2,52,56,6,2,2,36,40,51,347,10,1,358,142,500
3473,1,75,18,1,2,52,47,8,1,4,24,58,51,342,10,0,352,148,500
3474,1,111,16,1,4,34,56,6,4,1,31,43,66,374,7,1,382,118,500
3475,2,93,30,0,2,42,67,6,7,2,28,39,52,370,11,1,382,118,500
3476,1,103,11,1,2,40,45,7,2,4,19,43,75,353,8,3,364,152,516
3477,1,150,25,2,11,38,86,5,3,2,21,49,80,473,3,0,476,124,600
3478,0,177,20,0,2,56,65,2,1,5,16,64,72,480,3,0,483,117,600
3479,1,151,16,0,2,43,63,5,10,5,26,72,85,479,5,0,484,116,600
3480,0,142,11,0,4,51,78,3,3,2,22,73,70,459,5,0,464,136,600
3481,0,155,14,2,0,44,64,4,6,2,19,59,66,435,4,0,439,161,600
3482,0,143,20,0,1,47,81,3,9,2,24,61,76,467,6,0,473,127,600
3483,2,157,10,1,4,47,72,4,8,3,16,60,74,458,8,1,467,133,600
3484,1,168,16,1,2,53,71,5,1,6,19,42,76,461,2,0,463,137,600
3485,0,137,34,1,3,46,75,3,5,2,24,54,81,465,9,2,476,124,600
3486,0,127,20,1,2,41,103,7,6,5,22,62,67,463,7,1,471,129,600
3487,0,144,14,2,4,39,58,5,6,2,13,53,76,416,4,1,421,129,550
3488,0,147,13,0,3,40,57,10,3,4,14,69,47,407,7,0,414,136,550
3489,0,146,18,1,4,44,75,7,4,0,15,34,64,412,3,0,415,138,553
3490,1,63,60,0,1,39,49,11,3,2,18,83,29,359,14,2,375,225,600
3491,0,71,57,2,7,33,47,5,5,3,27,67,53,377,12,1,390,210,600
3492,3,85,63,2,2,44,46,9,3,3,14,83,22,379,10,2,391,209,600
3493,1,93,60,2,6,36,60,5,3,3,24,83,29,405,6,1,412,188,600
3494,1,96,67,2,0,26,54,10,4,1,16,89,31,397,6,2,405,195,600
3495,2,63,68,0,3,40,50,10,1,6,18,89,39,389,5,2,396,204,600
3496,3,76,65,0,4,32,53,6,3,0,23,80,35,380,9,1,390,210,600
3497,1,54,59,0,4,25,47,9,4,1,17,84,36,341,6,0,347,184,531
3498,1,53,29,1,1,25,64,4,2,3,20,69,39,311,12,1,324,176,500
3499,2,51,37,0,2,33,73,5,2,6,14,55,50,330,5,2,337,214,551
3500,2,160,12,0,2,54,79,6,5,5,26,53,64,468,4,0,472,128,600
3501,4,134,16,1,0,51,90,6,4,4,18,54,83,465,4,0,469,131,600
3502,3,148,24,0,2,45,92,3,4,5,20,37,90,473,6,1,480,120,600
3503,0,122,25,2,2,51,106,8,4,1,22,57,69,469,6,2,477,123,600
3504,2,129,20,0,1,33,96,2,4,0,21,56,66,430,5,0,435,165,600
3505,1,132,22,0,1,42,99,5,2,1,37,64,81,487,2,1,490,110,600
3506,0,135,13,0,2,43,90,9,4,5,28,43,70,442,7,0,449,151,600
3507,1,150,19,0,2,51,84,1,4,1,23,48,70,454,3,2,459,141,600
3508,1,148,21,2,2,37,107,4,1,2,25,46,61,457,9,0,466,134,600
3509,2,125,16,0,1,60,86,12,0,2,16,53,82,455,4,1,460,140,600
3510,3,134,20,1,1,29,82,4,7,5,21,56,81,444,11,1,456,144,600
3511,1,128,24,1,4,42,97,5,6,0,30,61,78,477,1,0,478,122,600
3512,2,134,9,2,1,40,118,6,4,3,31,47,63,460,3,0,463,137,600
3513,1,116,22,0,2,42,102,3,3,3,22,57,89,462,3,0,465,135,600
3514,0,132,12,2,2,44,111,7,0,2,25,59,59,455,3,0,458,142,600
3515,5,154,15,2,2,37,116,5,3,2,27,56,68,492,6,0,498,102,600
3516,1,123,13,5,2,42,73,4,8,1,13,50,45,380,2,2,384,116,500
3517,0,104,7,0,3,37,89,6,5,1,11,42,67,372,4,0,376,124,500
3518,2,102,8,0,2,40,91,4,2,2,22,48,59,382,3,2,387,113,500
3519,1,104,23,0,0,25,98,4,4,1,14,41,45,360,1,1,362,135,497
3520,1,68,12,0,2,30,70,1,1,3,43,30,63,324,6,1,331,169,500
3521,1,42,15,1,0,41,88,7,3,3,30,34,70,335,1,2,338,162,500
3522,3,63,12,0,1,38,83,1,0,2,34,29,81,347,6,1,354,145,499
3523,1,88,7,0,1,24,177,3,0,3,40,59,21,424,1,1,426,132,558
3524,2,82,9,1,7,41,129,1,3,4,17,52,35,383,5,0,388,162,550
3525,1,88,5,1,2,26,135,8,0,7,24,54,31,382,7,2,391,159,550
3526,2,91,2,1,1,26,97,2,4,1,22,44,15,308,8,2,318,126,444
3527,1,101,2,1,5,43,127,1,3,4,22,56,56,422,4,2,428,141,569
3528,2,65,7,0,3,39,142,4,4,1,40,44,53,404,6,4,414,155,569
3529,0,73,0,0,3,16,170,3,2,3,34,29,33,366,5,1,372,178,550
3530,0,92,2,0,0,9,128,2,3,7,30,43,32,348,2,2,352,192,544
3531,2,73,2,3,0,21,83,0,7,5,18,21,67,302,7,0,309,91,400
3532,0,65,2,1,0,34,105,0,13,0,11,11,65,307,1,2,310,65,375
3533,0,57,3,1,1,21,85,1,2,1,21,34,21,248,4,3,255,145,400
3534,0,45,2,0,0,12,45,2,0,0,25,39,19,189,2,1,192,111,303
3535,2,84,7,0,1,23,72,2,0,1,29,46,19,286,0,1,287,113,400
3536,0,71,9,0,0,12,77,1,0,1,23,37,15,246,6,0,252,77,329
3537,0,50,0,1,1,28,85,10,2,3,22,51,26,279,8,3,290,86,376
3538,2,139,4,1,2,63,109,5,1,7,48,23,61,465,4,0,469,131,600
3539,3,98,10,1,2,45,134,4,6,6,64,19,67,459,13,2,474,126,600
3540,4,98,8,4,2,79,106,3,2,8,53,33,50,450,9,4,463,137,600
3541,4,83,7,0,1,69,99,5,5,2,56,22,93,446,8,1,455,145,600
3542,4,97,11,2,2,59,97,6,2,6,60,22,73,441,6,4,451,149,600
3543,3,103,6,3,3,30,111,3,2,3,42,20,66,395,12,3,410,140,550
3544,2,102,6,1,3,36,80,3,6,6,39,18,60,362,8,3,373,177,550
3545,2,90,5,1,0,49,86,5,4,4,51,12,45,354,7,3,364,86,450
3546,2,157,15,2,1,57,71,6,10,3,20,61,86,491,3,0,494,106,600
3547,0,153,16,0,1,78,92,3,2,1,22,33,74,475,10,1,486,114,600
3548,2,126,20,4,6,79,79,2,11,2,12,55,68,466,3,1,470,130,600
3549,2,126,18,0,2,91,74,3,1,1,27,36,87,468,9,2,479,121,600
3550,0,137,7,0,3,52,87,3,10,2,14,35,62,412,3,0,415,85,500
3551,2,117,13,0,2,66,56,3,6,2,21,33,59,380,6,3,389,111,500
3552,0,111,7,2,2,56,62,0,12,3,25,35,93,408,8,3,419,81,500
3553,1,103,7,0,1,49,82,3,4,1,15,32,87,385,3,0,388,96,484
3554,0,28,2,3,2,54,34,1,1,1,11,19,17,173,1,1,175,67,242
3555,1,119,8,1,7,65,97,7,4,4,16,54,73,456,5,0,461,143,604
3556,1,128,21,1,5,72,71,6,2,0,19,73,65,464,2,0,466,138,604
3557,0,128,15,1,3,61,65,5,2,4,31,72,60,447,4,1,452,152,604
3558,3,148,5,2,3,70,79,5,3,1,28,66,65,478,4,0,482,122,604
3559,1,143,18,1,3,62,71,1,4,5,25,65,71,470,4,2,476,128,604
3560,1,140,13,1,2,70,55,5,9,2,34,65,71,468,7,1,476,128,604
3561,1,70,13,1,0,52,84,9,4,10,40,28,45,357,6,4,367,233,600
3562,1,96,5,2,1,47,124,3,1,5,41,32,30,388,8,2,398,202,600
3563,2,85,16,0,6,43,106,6,1,4,41,42,38,390,6,0,396,204,600
3564,5,85,18,1,0,47,110,4,4,7,39,25,39,384,19,2,405,190,595
3565,1,70,16,1,1,50,100,3,2,4,24,25,52,349,5,2,356,144,500
3573,1,45,4,0,1,22,53,5,3,5,13,37,57,246,7,1,254,196,450
3574,3,30,5,0,1,26,70,3,0,5,15,22,61,241,7,0,248,202,450
3575,0,18,7,0,1,18,90,1,5,0,21,18,24,203,6,0,209,91,300
3576,1,121,1,0,1,101,63,4,2,4,32,73,46,449,5,0,454,146,600
3577,3,123,2,0,2,104,64,3,6,2,26,43,56,434,4,0,438,162,600
3578,2,148,4,0,4,109,66,4,5,4,27,51,48,472,4,1,477,123,600
3579,0,159,3,0,4,114,63,4,2,5,30,31,68,483,1,1,485,115,600
3580,2,130,5,1,2,100,68,1,8,6,25,53,60,461,2,0,463,137,600
3581,2,111,3,1,9,93,71,2,3,4,29,57,56,441,2,1,444,156,600
3582,1,102,5,3,3,108,64,1,1,3,36,48,74,449,5,0,454,146,600
3583,3,130,2,0,5,110,69,3,2,1,29,43,54,451,5,0,456,144,600
3584,2,154,3,1,7,70,72,3,1,2,30,48,59,452,1,1,454,146,600
3585,2,139,3,0,4,110,56,2,2,5,41,24,46,434,3,2,439,161,600
3586,1,128,5,0,5,99,55,5,3,2,25,55,65,448,7,0,455,145,600
3591,4,135,5,2,7,102,80,2,7,4,19,38,47,452,7,1,460,140,600
3592,2,134,4,2,3,98,78,2,6,3,20,31,87,470,5,2,477,123,600
3593,1,129,3,2,6,105,59,4,2,0,24,42,58,435,5,0,440,160,600
3594,2,138,2,0,2,97,64,4,4,1,24,45,65,448,6,2,456,144,600
3595,1,140,10,3,3,138,60,2,5,3,23,44,51,483,4,0,487,113,600
3596,3,150,3,0,2,90,74,3,4,3,23,51,57,463,4,0,467,133,600
3597,5,161,5,3,3,83,56,2,5,0,33,45,62,463,0,0,463,137,600
3598,0,138,1,3,3,99,76,0,1,5,40,40,59,465,5,0,470,140,610
3599,2,143,1,0,0,119,82,2,1,2,23,43,64,482,1,4,487,123,610
3600,1,125,1,0,2,136,75,1,2,5,33,37,51,469,5,0,474,136,610
3566,1,61,27,0,2,54,105,3,0,1,35,26,33,348,4,1,353,129,482
3567,0,87,17,0,13,43,100,4,4,4,23,51,70,416,6,3,425,178,603
3568,2,86,9,0,0,46,90,7,4,1,31,64,86,426,3,0,429,174,603
3569,2,99,12,0,2,49,119,3,8,3,17,49,66,429,1,0,430,173,603
3570,1,102,12,0,1,58,84,6,9,2,37,59,71,442,11,1,454,149,603
3571,5,106,19,3,3,44,85,8,4,3,27,63,76,446,2,0,448,158,606
3572,2,28,3,0,5,30,70,6,2,0,22,25,48,241,13,3,257,199,456
3587,1,156,4,0,4,88,76,1,3,3,27,51,56,470,5,0,475,125,600
3588,2,148,5,0,2,117,72,3,3,2,19,45,63,481,1,0,482,118,600
3589,2,170,3,1,6,83,85,1,3,0,12,34,68,468,4,0,472,128,600
3590,1,129,6,0,1,107,72,2,8,2,15,33,63,439,2,1,442,158,600
3601,0,150,4,0,3,107,58,4,5,2,33,40,44,450,9,1,460,150,610
3602,0,133,2,2,0,75,70,6,3,2,22,55,66,436,4,1,441,165,606
3603,2,104,7,0,2,89,81,0,3,5,20,59,33,405,5,0,410,190,600
3604,1,78,10,1,2,69,66,4,2,4,27,80,53,397,11,1,409,191,600
3605,0,65,8,4,1,66,64,3,8,4,17,54,36,330,4,2,336,164,500
3606,3,49,8,0,2,44,64,3,3,4,16,52,25,273,4,0,277,141,418
3607,1,42,4,0,5,46,52,3,2,4,21,36,22,238,10,0,248,202,450
3608,3,47,1,0,4,71,72,1,0,2,25,34,26,286,6,0,292,143,435
3609,4,66,1,1,3,54,86,3,1,0,19,92,22,352,9,2,363,137,500
3610,1,46,1,0,0,59,105,2,3,3,28,93,29,370,5,0,375,125,500
3611,1,54,2,0,1,49,55,3,2,5,26,97,23,318,10,1,329,121,450
3612,0,89,0,0,1,54,73,0,2,1,27,35,16,298,3,2,303,97,400
3613,2,54,1,0,2,36,50,2,0,0,36,48,19,250,2,2,254,123,377
3614,2,56,2,0,2,25,81,1,2,1,18,128,30,348,5,0,353,133,486
3615,5,62,11,1,3,88,85,12,2,6,25,56,33,389,3,1,393,186,579
3616,0,54,1,1,1,30,54,2,0,0,12,26,23,204,1,3,208,104,312
3617,3,70,0,0,4,72,70,1,0,1,35,45,32,333,2,3,338,199,537
3618,3,147,2,1,4,60,52,7,6,9,50,52,51,444,1,3,448,152,600
3619,0,128,0,0,2,60,53,4,3,1,78,34,74,437,7,0,444,156,600
3620,3,127,5,1,2,67,65,5,6,3,58,58,43,443,7,0,450,150,600
3621,3,116,6,1,0,73,74,2,5,7,60,38,47,432,6,0,438,162,600
3622,4,133,3,2,2,72,50,4,4,4,72,42,46,438,6,2,446,154,600
3623,1,121,3,1,2,61,37,1,3,5,44,27,39,345,4,2,351,149,500
3624,1,111,1,2,3,65,56,1,1,4,54,27,47,373,4,1,378,122,500
3625,0,83,2,1,2,52,35,7,3,2,61,36,50,334,2,0,336,99,435
3626,2,58,1,0,1,52,34,0,1,3,31,26,17,226,3,2,231,129,360
3627,2,67,2,0,0,29,37,0,3,2,33,22,37,234,1,3,238,122,360
3628,1,51,0,0,1,68,75,5,1,1,47,35,32,317,10,5,332,218,550
3629,1,53,2,2,1,79,62,3,1,2,62,45,49,362,25,3,390,160,550
3630,1,66,3,1,2,63,77,3,3,2,76,35,48,380,17,1,398,140,538
3631,1,11,0,1,2,24,22,1,1,2,50,17,22,154,0,1,155,45,200
3632,1,48,3,1,1,42,38,0,1,3,37,34,36,245,3,1,249,159,408
3633,0,108,5,1,5,59,103,2,3,4,71,44,38,443,7,2,452,148,600
3634,2,139,12,1,2,75,80,5,4,1,32,56,57,466,5,2,473,127,600
3635,2,91,4,4,4,63,89,0,5,2,43,78,32,417,0,1,418,182,600
3636,3,103,3,1,12,56,64,3,3,5,59,62,62,436,11,2,449,151,600
3637,1,103,3,1,5,43,68,4,4,3,23,61,43,362,13,0,375,125,500
3638,3,88,5,0,2,48,68,3,0,4,45,47,52,365,3,1,369,125,494
3639,1,161,2,0,2,68,53,2,1,2,22,28,75,417,4,0,421,100,521
3640,0,32,2,0,1,27,40,2,0,5,30,20,20,179,4,0,183,83,266
3641,3,78,1,4,1,50,63,2,2,9,36,13,26,288,2,1,291,103,394
3642,1,6,2,1,0,17,25,0,0,0,5,7,2,66,1,0,67,23,90
3643,9,88,8,1,2,80,41,8,7,6,39,77,47,413,4,2,419,181,600
3644,5,76,8,0,3,88,76,4,2,4,26,72,44,408,5,0,413,187,600
3645,5,110,7,0,5,80,55,8,8,3,31,70,46,428,3,0,431,169,600
3646,2,72,19,0,3,60,71,7,1,5,27,77,32,376,10,3,389,211,600
3647,9,79,7,1,8,87,41,8,5,4,40,89,43,421,11,0,432,168,600
3648,5,86,7,0,7,75,59,5,3,5,26,87,53,418,9,1,428,172,600
3649,0,74,7,1,5,62,61,9,3,3,37,84,38,384,7,0,391,209,600
3650,11,90,2,0,8,59,67,10,4,7,35,91,40,424,7,1,432,168,600
3651,9,86,9,1,3,66,88,5,3,5,33,70,43,421,5,1,427,173,600
3652,5,72,13,0,4,61,54,9,1,2,38,88,45,392,3,2,397,203,600
3653,2,106,11,0,5,75,56,4,6,1,25,94,35,420,11,2,433,167,600
3654,5,86,13,1,6,77,60,7,1,5,40,87,42,430,5,2,437,163,600
3655,7,88,13,1,6,80,48,8,4,3,29,73,53,413,8,1,422,178,600
3656,5,76,14,1,3,76,45,8,3,1,38,73,46,389,9,2,400,200,600
3657,5,80,12,0,2,67,63,9,9,4,30,91,44,416,10,1,427,173,600
3658,6,91,6,0,2,64,42,8,6,7,36,79,62,409,8,1,418,182,600
3659,2,88,9,1,3,78,54,7,5,6,35,95,52,435,4,0,439,161,600
3660,1,77,17,2,5,62,66,7,5,8,31,71,41,393,4,0,397,203,600
3661,5,64,15,0,3,58,45,8,2,3,25,66,34,328,5,2,335,166,501
3662,0,117,1,0,5,43,103,5,3,2,19,70,81,449,1,0,450,150,600
3663,2,132,5,1,3,43,78,4,4,2,29,69,83,455,2,0,457,143,600
3664,3,140,3,3,3,33,72,5,7,0,28,72,86,455,5,0,460,140,600
3665,0,130,3,1,3,26,91,6,5,5,22,63,98,453,3,0,456,144,600
3666,3,133,9,1,6,36,76,1,6,2,19,68,99,459,1,0,460,140,600
3667,0,133,3,0,4,37,96,7,8,1,23,59,89,460,2,1,463,137,600
3668,1,127,3,0,3,37,90,9,4,2,24,68,91,459,5,1,465,135,600
3669,0,150,5,1,4,26,90,2,4,1,20,69,88,460,2,0,462,138,600
3670,0,127,6,0,5,47,74,2,3,2,22,69,76,433,4,0,437,163,600
3671,0,124,5,3,5,32,70,2,6,0,18,89,93,447,3,0,450,150,600
3672,0,125,2,1,2,29,88,4,4,3,16,56,92,422,2,0,424,176,600
3673,2,128,6,2,4,38,79,3,3,2,19,65,98,449,2,0,451,149,600
3674,1,124,6,1,1,43,101,4,4,5,21,53,92,456,1,0,457,143,600
3675,1,104,4,1,2,45,118,2,7,5,25,56,81,451,5,1,457,143,600
3676,2,143,2,0,3,36,74,3,2,4,36,60,91,456,3,1,460,140,600
3677,2,108,4,1,2,48,99,4,5,4,29,55,101,462,1,0,463,137,600
3678,0,139,5,1,3,35,83,4,7,5,30,64,75,451,3,0,454,146,600
3679,0,109,4,0,3,37,74,3,8,3,29,45,66,381,1,0,382,118,500
3680,2,104,4,3,5,39,83,3,3,2,15,47,63,373,2,1,376,124,500
3681,3,102,1,0,3,28,93,5,4,3,28,67,75,412,1,0,413,135,548
3682,4,104,2,0,7,38,66,3,2,2,15,81,92,416,5,3,424,176,600
3683,2,107,6,2,4,24,64,4,4,1,19,87,100,424,4,1,429,171,600
3684,0,103,1,2,6,41,82,1,3,1,17,79,89,425,4,1,430,170,600
3685,3,131,3,0,7,34,53,5,8,2,17,81,88,432,0,0,432,166,598
3686,1,103,3,0,2,35,63,3,12,2,21,104,71,420,3,0,423,177,600
3687,1,103,5,0,4,34,72,1,5,2,18,92,95,432,0,0,432,165,597
3688,3,119,4,1,4,32,66,2,4,5,11,79,85,415,3,1,419,181,600
3689,0,106,2,1,3,25,68,3,5,5,24,77,87,406,5,0,411,189,600
3690,2,102,4,1,4,29,74,5,4,2,25,92,74,418,4,0,422,178,600
3691,2,89,2,1,1,30,60,7,5,3,15,74,64,353,1,0,354,146,500
3692,1,103,4,0,4,41,63,1,2,3,27,82,68,399,2,0,401,126,527
3693,1,72,2,0,3,34,47,4,2,2,26,119,61,373,5,0,378,222,600
3694,1,75,1,0,1,38,50,7,6,3,25,115,61,383,5,1,389,211,600
3695,3,77,6,2,0,41,37,6,5,3,24,119,51,374,3,0,377,223,600
3696,1,77,0,0,1,34,48,4,5,0,23,113,56,362,5,1,368,232,600
3697,0,75,2,1,4,34,47,5,1,5,21,110,68,373,0,0,373,227,600
3698,2,56,4,0,0,33,48,5,5,3,23,122,60,361,3,0,364,236,600
3699,2,78,0,1,3,27,41,6,4,3,20,122,61,368,3,0,371,229,600
3700,3,63,2,0,2,34,41,5,2,4,25,105,53,339,0,1,340,192,532
3701,1,58,5,1,3,36,48,9,0,6,18,86,49,320,3,0,323,209,532
3702,1,68,1,0,2,32,46,5,2,3,18,104,56,338,6,2,346,186,532
3703,0,68,3,0,1,21,62,6,4,4,8,103,54,334,3,1,338,233,571
3704,1,50,3,0,2,23,54,7,10,3,8,128,52,341,4,0,345,226,571
3705,0,116,0,0,4,28,77,3,3,1,11,64,109,416,4,2,422,137,559
3706,1,125,3,1,4,26,84,1,4,2,13,69,108,441,2,0,443,116,559
3707,0,133,3,1,3,26,89,4,5,1,15,45,122,447,2,0,449,110,559
3708,0,124,1,0,6,32,86,4,4,2,17,46,99,421,2,0,423,136,559
3709,0,113,1,0,2,35,99,3,5,1,10,66,94,429,0,0,429,130,559
3710,1,128,2,1,5,26,105,3,1,1,15,71,87,446,0,0,446,113,559
3711,3,111,3,0,3,33,95,1,6,2,8,55,109,429,0,1,430,129,559
3712,1,120,1,1,0,23,86,6,1,2,19,58,105,423,0,1,424,135,559
3713,1,120,5,0,4,51,75,1,4,2,14,118,74,469,5,1,475,125,600
3714,1,130,1,0,3,38,75,6,3,0,11,99,94,461,2,0,463,137,600
3715,1,127,0,1,1,28,60,3,2,0,11,74,65,373,1,2,376,124,500
3716,0,129,0,1,5,22,64,5,3,1,6,90,51,377,1,0,378,122,500
3717,0,130,5,0,2,35,53,3,7,3,9,83,58,388,1,0,389,111,500
3718,2,106,2,0,3,33,57,6,4,2,9,76,72,372,5,1,378,122,500
3719,3,113,1,1,0,30,55,5,3,1,12,78,72,374,0,0,374,126,500
3720,6,123,2,0,7,24,67,3,6,2,11,91,71,413,2,0,415,144,559
3721,2,137,3,1,4,32,72,1,8,0,26,90,73,449,0,2,451,149,600
3722,3,113,1,1,3,51,75,7,2,1,25,82,69,433,2,0,435,165,600
3723,2,129,5,1,2,36,90,3,5,1,24,82,80,460,4,0,464,136,600
3724,1,115,5,0,4,29,88,5,10,0,16,71,91,435,0,0,435,165,600
3725,3,113,5,1,5,30,84,5,6,3,20,79,85,439,2,0,441,159,600
3726,1,103,2,0,5,37,69,4,8,1,23,62,64,379,2,0,381,119,500
3727,0,126,4,0,1,33,68,1,6,0,24,55,71,389,2,2,393,107,500
3728,3,92,4,0,1,39,67,4,7,1,17,84,90,409,0,0,409,128,537
3729,4,50,7,1,0,34,89,8,5,2,36,77,37,350,4,2,356,204,560
3730,2,52,6,1,1,44,62,3,4,6,18,88,55,342,7,5,354,206,560
3731,2,46,7,0,3,36,52,2,2,2,14,153,29,348,7,3,358,242,600
3732,2,54,4,0,4,40,58,6,1,1,16,143,32,361,3,0,364,236,600
3733,8,41,7,0,1,38,31,5,0,2,18,104,33,288,3,0,291,209,500
3734,0,41,2,0,1,45,41,6,1,3,16,116,23,295,1,0,296,230,526
3735,0,88,2,1,0,28,66,5,2,3,23,90,56,364,4,1,369,131,500
3736,2,92,4,1,1,30,56,8,4,3,33,66,56,356,3,0,359,139,498
3737,3,112,3,0,5,46,84,7,6,4,23,73,65,431,2,0,433,167,600
3738,4,141,1,1,5,38,60,5,4,2,23,110,61,455,4,0,459,141,600
3739,1,122,3,1,1,45,68,3,4,3,24,93,71,439,0,0,439,161,600
3740,2,118,5,1,5,31,83,5,5,5,27,72,81,440,2,0,442,158,600
3741,2,125,10,1,5,33,77,8,5,3,20,93,60,442,3,0,445,155,600
3742,0,112,2,1,2,35,74,4,2,5,26,84,79,426,2,0,428,172,600
3743,2,108,3,0,2,43,62,4,7,1,26,79,68,405,0,0,405,195,600
3744,2,122,6,0,3,32,56,8,1,2,27,81,96,436,4,1,441,159,600
3745,2,104,3,0,8,37,63,5,3,5,18,94,103,445,3,0,448,152,600
3746,3,96,3,1,4,42,81,12,1,1,19,86,71,420,5,0,425,175,600
3747,0,98,3,1,4,26,68,6,7,2,21,83,100,419,6,0,425,175,600
3748,3,129,3,1,2,35,87,3,1,3,18,86,62,433,4,1,438,162,600
3749,3,133,2,1,7,31,70,5,4,5,21,81,75,438,5,0,443,157,600
3750,0,115,3,0,6,34,66,12,7,2,23,79,76,423,7,1,431,169,600
3751,2,94,2,0,6,32,46,2,2,2,21,82,59,350,0,2,352,148,500
3752,1,116,2,0,5,28,60,5,4,3,28,77,61,390,2,0,392,162,554
3753,1,69,2,0,1,29,35,4,3,1,11,63,33,252,1,0,253,97,350
3754,1,47,1,0,4,26,41,3,1,3,13,58,44,242,4,0,246,99,345
3755,2,31,6,1,0,30,44,14,4,9,18,72,44,275,2,1,278,222,500
3756,0,65,4,2,1,40,36,2,3,5,20,88,26,292,3,0,295,205,500
3757,2,51,3,1,3,29,38,4,3,3,19,72,40,268,0,0,268,182,450
3758,7,56,2,0,1,35,46,1,3,1,22,60,33,267,5,0,272,176,448
3759,1,48,1,0,3,17,29,5,3,0,12,54,31,204,3,1,208,90,298
3760,2,77,1,0,4,32,50,3,1,1,26,73,65,335,6,4,345,217,562
3761,0,58,7,1,0,24,58,5,5,1,33,86,107,385,0,1,386,176,562
3762,1,88,3,0,7,27,82,4,1,4,27,68,74,386,5,1,392,170,562
3763,0,63,0,0,4,29,68,4,3,4,36,85,82,378,1,1,380,181,561
3764,0,85,2,1,3,30,66,5,3,0,28,66,82,371,4,1,376,185,561
3765,1,74,2,1,3,42,46,3,2,2,36,71,84,367,2,0,369,192,561
3766,1,68,8,2,3,47,79,6,1,4,27,116,46,408,7,1,416,184,600
3767,0,55,2,2,1,35,58,3,5,2,24,92,52,331,1,0,332,168,500
3768,0,49,0,0,1,28,72,5,2,2,28,87,57,331,4,0,335,165,500
3769,3,47,3,0,6,24,74,3,0,3,28,96,53,340,7,0,347,153,500
3770,3,56,4,1,0,27,89,4,5,5,20,77,51,342,1,0,343,168,511
3771,0,133,6,0,5,18,71,8,1,2,15,87,91,437,4,0,441,159,600
3772,1,105,7,2,1,39,92,11,5,1,7,98,84,453,1,0,454,146,600
3773,2,124,4,2,1,23,73,6,0,1,19,68,99,422,4,3,429,171,600
3774,2,133,5,0,0,34,53,6,3,5,10,77,92,420,4,0,424,176,600
3775,0,86,3,1,6,27,65,9,3,2,13,67,79,361,2,0,363,137,500
3776,0,122,6,1,0,31,64,8,3,0,16,63,66,380,4,0,384,147,531
3777,0,2,0,1,1,1,13,0,0,1,1,0,3,23,1,0,24,61,85
3778,2,45,2,0,2,26,44,7,0,3,21,117,33,302,5,1,308,226,534
3779,5,55,3,2,3,35,85,4,1,0,22,73,43,331,2,0,333,201,534
3780,0,48,1,1,1,27,52,12,2,1,21,90,28,284,13,2,299,234,533
3781,1,41,1,0,3,33,44,7,3,1,17,111,29,291,5,0,296,237,533
3782,0,41,0,0,1,40,51,3,0,3,11,120,38,308,8,0,316,217,533
3783,2,32,1,0,3,18,53,4,1,1,16,142,29,302,1,0,303,211,514
3784,3,45,1,0,2,19,54,8,0,1,12,129,34,308,2,1,311,0,311
3785,3,34,2,3,4,29,48,5,1,2,9,119,32,291,8,2,301,212,513
3786,0,23,1,0,2,20,48,11,2,1,17,123,33,281,4,7,292,221,513
3787,3,35,2,0,2,24,41,2,1,4,15,138,24,291,1,0,292,221,513
3788,1,40,3,1,1,22,47,4,2,1,6,134,30,292,4,1,297,216,513
3789,2,114,7,0,8,35,108,4,2,3,29,53,63,428,8,0,436,164,600
3790,2,120,4,1,6,26,111,3,6,2,12,31,49,373,4,3,380,120,500
3791,2,102,1,0,1,33,99,4,8,1,12,32,46,341,4,0,345,155,500
3792,6,129,2,1,6,18,107,3,4,3,25,36,25,365,1,1,367,133,500
3793,1,127,3,0,7,37,129,2,3,1,15,25,41,391,5,1,397,103,500
3794,2,105,9,1,7,24,116,3,4,2,34,35,47,389,3,1,393,134,527
3795,3,75,1,2,3,49,66,1,4,2,24,52,18,300,6,0,306,151,457
3796,2,87,1,2,2,41,71,1,2,3,32,57,22,323,5,1,329,128,457
3797,0,72,1,2,1,41,57,7,5,4,23,65,21,299,8,1,308,149,457
3798,0,17,0,0,0,5,5,1,1,0,0,5,4,38,1,0,39,13,52
3799,1,85,3,1,5,35,98,7,2,4,21,118,38,418,5,1,424,190,614
3800,0,1,2,0,1,0,10,0,2,0,1,0,1,18,0,0,18,21,39
3801,1,46,1,0,0,21,66,6,7,0,17,22,8,195,4,1,200,111,311
3802,1,116,12,2,2,23,68,1,4,5,69,70,52,425,5,1,431,169,600
3803,0,88,26,1,1,21,74,3,4,0,70,63,44,395,7,3,405,195,600
3804,1,85,22,0,7,34,73,2,2,1,67,68,28,390,12,5,407,193,600
3805,1,125,12,0,1,22,65,3,6,2,55,50,45,387,8,3,398,152,550
3806,1,42,1,1,1,14,58,0,2,1,29,65,20,235,7,4,246,104,350
3807,0,22,5,1,3,7,55,6,2,3,27,54,22,207,6,1,214,124,338
3808,1,28,4,0,1,21,61,1,1,2,38,40,16,214,10,0,224,126,350
3809,1,40,1,0,10,21,48,3,1,1,26,61,17,230,4,1,235,102,337
3810,1,58,1,1,5,37,87,2,1,2,22,56,37,310,9,1,320,180,500
3811,2,79,1,0,3,36,102,2,4,0,29,46,19,323,6,0,329,171,500
3812,1,88,0,1,3,44,87,3,1,0,21,60,18,327,2,0,329,171,500
3813,2,79,1,1,4,42,85,2,1,1,20,59,37,334,3,1,338,159,497
3814,0,4,1,0,2,9,36,0,0,1,5,45,5,108,3,0,111,75,186
3815,3,108,6,1,4,80,163,2,2,2,25,51,38,485,12,2,499,143,642
3816,0,147,3,2,9,36,69,4,4,1,17,69,52,413,1,1,415,185,600
3817,1,155,3,0,6,45,93,2,4,3,19,78,57,466,0,0,466,134,600
3818,1,148,0,2,8,45,76,2,2,0,19,72,58,433,2,1,436,164,600
3819,2,151,1,0,5,34,77,1,1,0,18,68,62,420,2,0,422,178,600
3820,4,153,1,0,11,39,95,2,1,2,16,62,70,456,1,0,457,143,600
3821,1,133,2,3,2,24,63,0,1,0,15,63,63,370,3,2,375,125,500
3822,1,119,1,0,5,25,71,3,2,1,10,61,46,345,4,0,349,151,500
3823,1,138,3,0,7,24,54,2,3,4,23,76,49,384,1,1,386,133,519
3824,0,117,4,0,7,48,55,3,2,2,9,66,39,352,4,0,356,144,500
3825,0,108,1,1,4,20,42,4,5,1,14,65,50,315,4,0,319,131,450
3826,0,133,5,0,1,20,41,4,2,1,15,45,54,321,5,0,326,124,450
3827,1,95,6,1,10,31,49,0,0,1,19,43,36,292,4,1,297,162,459
3828,1,83,0,2,7,33,107,2,1,0,24,48,26,334,2,0,336,131,467
3829,0,71,0,1,1,46,82,5,2,1,22,38,25,294,8,4,306,161,467
3830,0,74,1,0,1,30,80,2,2,0,16,47,31,284,4,2,290,160,450
3831,0,76,3,3,1,25,72,0,2,3,20,47,27,279,2,0,281,125,406
3832,0,147,4,1,2,35,76,1,1,1,4,73,87,432,6,1,439,161,600
3833,2,147,1,0,2,42,63,2,1,0,26,66,75,427,1,0,428,172,600
3834,2,147,2,0,0,34,82,0,3,3,23,83,63,442,0,0,442,158,600
3835,0,131,3,2,2,37,83,1,2,4,22,87,82,456,0,0,456,144,600
3836,1,156,1,1,0,25,72,0,2,0,11,67,37,373,3,0,376,124,500
3837,0,133,1,1,0,37,68,1,3,2,8,55,61,370,1,1,372,128,500
3838,1,113,5,0,0,29,67,5,1,0,23,49,64,357,7,0,364,136,500
3839,2,105,3,0,2,25,94,0,1,3,11,55,47,348,2,0,350,150,500
3840,1,116,2,0,5,17,71,2,2,2,13,58,63,352,1,0,353,156,509
3841,1,30,1,0,0,12,48,2,2,0,7,12,31,146,1,0,147,93,240
3842,1,89,1,0,1,30,53,7,1,1,27,38,14,263,4,1,268,111,379
3843,1,68,2,1,2,25,59,2,0,2,20,38,34,254,5,1,260,118,378
3844,0,20,0,0,1,3,19,0,0,0,5,17,7,72,4,1,77,69,146
3845,1,125,3,0,1,34,58,2,4,3,17,45,47,340,1,2,343,107,450
3846,1,107,0,1,0,25,59,1,3,1,15,48,45,306,3,2,311,113,424
3847,2,35,0,2,1,24,49,2,0,1,4,76,19,215,7,0,222,128,350
3848,0,27,2,0,1,21,35,1,2,1,8,102,17,217,7,2,226,116,342
3849,0,114,3,1,3,34,57,2,1,1,21,114,51,402,4,2,408,192,600
3850,2,130,4,0,0,28,56,0,5,7,29,93,57,411,3,0,414,186,600
3851,0,98,2,2,4,25,49,1,0,3,18,116,50,368,7,1,376,174,550
3852,1,127,1,0,0,27,50,2,2,3,12,109,64,398,3,2,403,147,550
3853,0,103,3,1,2,29,54,1,0,5,23,78,59,358,5,1,364,186,550
3854,0,94,1,2,3,24,51,4,1,4,18,91,54,347,6,0,353,169,522
3855,0,2,1,0,1,0,17,1,1,0,4,2,7,36,1,1,38,22,60
3856,2,176,0,0,1,36,83,4,3,2,15,83,52,457,5,1,463,137,600
3857,1,161,1,1,2,42,61,1,3,0,19,86,55,433,2,0,435,165,600
3858,2,153,4,0,2,38,59,2,1,0,14,92,38,405,2,2,409,191,600
3859,1,153,2,1,1,52,75,2,3,3,21,70,46,430,3,0,433,167,600
3860,1,179,2,0,2,44,99,0,1,2,20,51,56,457,6,0,463,161,624
3861,1,77,1,0,3,7,114,1,0,1,13,24,75,317,6,0,323,115,438
3862,1,109,10,0,1,30,68,3,2,1,36,62,58,381,6,1,388,212,600
3863,2,93,7,2,0,29,64,5,1,7,22,76,62,370,4,2,376,224,600
3864,0,109,5,0,1,30,68,5,2,3,23,70,57,373,4,2,379,221,600
3865,1,97,8,0,1,18,66,2,0,4,30,77,50,354,8,2,364,236,600
3866,3,122,11,0,2,22,69,2,2,3,23,71,56,386,12,1,399,201,600
3867,2,92,15,1,1,15,61,2,1,1,19,68,41,319,4,2,325,189,514
3868,0,22,0,0,0,7,19,0,0,0,4,19,6,77,1,0,78,75,153
3869,0,24,1,0,0,5,48,3,1,0,0,27,7,116,0,2,118,51,169
3870,0,26,2,0,1,12,61,0,1,2,10,35,12,162,4,0,166,85,251
3871,0,61,0,1,0,4,37,2,1,1,3,22,12,144,1,0,145,35,180
3872,2,56,1,0,1,11,65,1,2,6,9,11,27,192,5,1,198,80,278
3873,3,63,8,0,6,19,69,3,1,4,21,76,51,324,6,0,330,170,500
3874,2,62,14,0,3,19,53,5,0,0,18,82,42,300,3,2,305,145,450
3875,2,64,8,1,1,22,64,1,0,2,35,84,38,322,4,1,327,123,450
3876,2,70,19,0,4,24,56,0,0,3,32,78,35,323,4,3,330,127,457
3877,0,12,0,0,1,2,7,1,0,0,0,5,4,32,1,1,34,20,54
3878,0,11,0,0,1,26,58,3,1,0,5,23,90,218,0,0,218,103,321
3879,0,92,1,0,1,21,52,1,1,1,9,23,29,231,5,0,236,128,364
3880,0,118,1,0,1,21,50,2,2,2,10,27,25,259,5,0,264,100,364
3881,0,100,0,1,5,16,70,1,0,4,15,29,25,266,4,3,273,155,428
3882,1,63,2,1,2,17,52,3,1,3,17,19,16,197,5,0,202,160,362
3883,2,68,1,1,0,22,48,6,1,1,26,17,27,220,1,1,222,139,361
3884,1,31,0,0,1,25,48,1,0,3,14,24,14,162,2,1,165,102,267
3885,0,99,0,2,3,24,61,2,3,3,26,22,20,265,4,1,270,109,379
3886,1,70,1,1,1,8,79,1,1,1,22,27,38,251,2,0,253,105,358
3887,1,23,0,0,3,17,26,2,1,1,7,4,9,94,0,0,94,49,143
3888,0,11,0,0,0,5,6,0,0,0,2,7,3,34,1,0,35,23,58
3889,0,18,11,0,0,23,11,1,0,1,2,5,17,89,2,0,91,58,149
3890,1,38,7,0,0,39,116,7,0,1,16,68,56,349,4,4,357,255,612
3891,0,45,3,1,3,45,129,3,2,2,11,67,52,363,8,1,372,240,612
3892,0,88,2,0,1,34,58,8,3,2,18,84,28,326,6,0,332,167,499
3893,2,66,2,0,2,29,43,7,0,1,21,40,37,250,5,0,255,127,382
3894,1,20,0,0,2,16,138,1,2,2,7,30,16,235,2,0,237,103,340
3895,1,31,3,0,10,7,88,1,0,6,13,30,17,207,5,0,212,83,295
3896,0,19,7,0,0,17,19,0,0,1,13,7,13,96,2,0,98,72,170
3897,1,48,1,1,2,31,200,1,3,3,7,114,18,430,6,2,438,174,612
3898,0,43,0,1,4,25,25,4,1,1,7,40,22,173,3,0,176,119,295
3899,2,74,2,0,1,26,75,2,1,3,14,61,34,295,7,2,304,196,500
3900,1,78,2,2,6,22,84,5,2,7,25,67,41,342,1,2,345,180,525
3901,1,103,2,1,1,18,71,0,2,3,31,39,56,328,5,1,334,127,461
3902,0,97,1,1,1,18,99,3,2,1,10,145,42,420,4,2,426,155,581
3903,0,102,20,0,5,30,58,2,1,2,18,89,53,380,3,1,384,145,529
3904,1,81,6,0,7,17,64,4,1,4,31,75,31,322,2,2,326,174,500
3905,3,63,4,0,5,28,57,3,1,3,24,80,29,300,4,2,306,181,487
3906,2,55,4,0,4,18,59,4,2,3,21,65,29,266,3,1,270,147,417
3907,0,48,0,1,1,22,39,0,1,3,24,87,49,275,0,0,275,141,416
3908,0,61,3,0,1,19,53,2,3,2,24,60,39,267,4,0,271,145,416
3909,0,33,1,1,3,6,31,0,0,1,9,63,15,163,2,0,165,72,237
3910,1,27,2,1,0,13,53,4,0,4,15,51,11,182,5,1,188,97,285
3911,0,2,0,0,0,2,6,1,0,0,1,21,10,43,0,0,43,24,67
3912,1,66,1,0,1,21,82,2,0,5,27,51,40,297,2,1,300,150,450
3913,2,58,2,0,3,24,79,1,2,4,27,62,30,294,3,2,299,151,450
3914,1,71,1,1,2,23,85,0,0,4,25,48,30,291,3,1,295,138,433
3915,0,8,5,0,1,9,23,2,0,2,5,14,12,81,3,0,84,75,159
3916,4,27,10,0,0,15,48,1,1,6,15,46,14,187,2,1,190,124,314
3917,3,122,1,0,5,39,81,2,0,3,18,69,49,392,11,1,404,174,578
3918,4,143,2,0,0,42,64,1,1,2,21,82,31,393,11,1,405,172,577
3919,1,138,3,0,6,31,72,1,2,6,20,71,50,401,7,0,408,192,600
3920,1,151,2,1,4,39,61,0,3,1,19,83,63,428,2,2,432,168,600
3921,0,117,0,0,3,25,74,4,4,2,15,77,44,365,2,0,367,133,500
3922,0,101,1,0,2,23,62,2,3,1,16,63,53,327,4,1,332,149,481
3923,2,90,1,2,3,16,74,6,6,4,28,82,27,341,6,1,348,161,509
3924,0,9,0,0,1,3,48,8,1,0,6,50,12,138,2,0,140,113,253
3925,2,56,1,1,1,28,67,7,0,3,18,88,77,349,10,4,363,215,578
3926,6,62,0,1,7,27,83,7,1,1,16,76,77,364,9,7,380,197,577
3927,4,57,6,0,5,38,51,1,4,2,20,83,43,314,11,3,328,172,500
3928,2,52,2,0,3,12,64,3,5,4,19,87,35,288,6,4,298,202,500
3929,1,70,10,2,3,30,56,6,6,6,12,79,36,317,8,3,328,172,500
3930,1,77,8,0,1,22,49,3,2,0,8,87,52,310,4,0,314,138,452
3931,1,62,0,2,5,33,56,2,1,1,18,39,56,276,1,4,281,138,419
3932,0,31,0,0,1,13,56,5,0,1,8,29,15,159,0,0,159,57,216
3933,0,89,4,4,2,25,37,1,1,2,29,119,59,372,4,4,380,220,600
3934,2,91,4,1,2,20,38,1,1,3,25,108,77,373,5,0,378,222,600
3935,1,94,5,0,2,35,44,1,1,2,19,104,50,358,7,0,365,185,550
3936,1,81,2,1,5,40,36,3,0,2,13,102,54,340,1,0,341,178,519
3937,1,23,20,0,0,6,22,4,2,1,7,49,40,175,8,1,184,216,400
3938,0,26,33,0,0,8,18,1,1,0,6,85,32,210,6,1,217,189,406
3939,0,5,2,0,0,1,11,1,0,3,0,48,62,133,3,3,139,152,291
3940,0,1,0,0,0,1,3,1,0,0,1,5,14,26,0,0,26,208,234
3941,0,3,1,0,0,2,1,1,0,1,1,2,47,59,4,0,63,285,348
3942,0,2,10,0,3,0,4,0,1,4,0,32,57,113,8,5,126,188,314
3943,0,6,1,1,3,4,4,1,1,0,3,19,30,73,5,1,79,138,217
3944,1,8,0,0,2,3,9,2,0,0,2,17,5,49,0,0,49,59,108
3945,1,3,22,0,1,13,27,1,1,0,3,21,56,149,8,3,160,337,497
3946,0,11,13,0,30,7,25,2,0,4,4,26,17,139,5,2,146,172,318
3947,0,0,0,0,0,0,4,2,0,0,0,0,0,6,1,2,9,65,74
3948,1,2,0,0,1,2,2,0,0,0,3,4,13,28,1,0,29,105,134
3949,0,0,0,1,0,0,3,0,0,0,0,1,7,12,1,0,13,13,26
3950,0,142,0,0,2,38,82,3,6,2,45,44,52,416,6,1,423,177,600
3951,3,122,3,0,1,51,88,4,11,0,24,52,46,405,5,4,414,186,600
3952,2,153,3,0,0,42,96,2,11,1,35,36,43,424,6,6,436,164,600
3953,1,111,3,2,0,20,54,1,4,3,33,47,53,332,7,0,339,161,500
3954,1,93,2,0,0,33,65,2,4,3,54,44,30,331,5,1,337,163,500
3955,0,104,0,0,3,24,55,4,12,6,38,44,51,341,4,1,346,153,499
3956,4,34,0,0,0,20,77,5,3,3,25,32,13,216,3,1,220,142,362
3957,0,25,1,0,0,8,29,0,2,0,13,15,3,96,1,1,98,66,164
3958,0,23,0,1,0,32,65,1,4,6,22,69,16,239,5,0,244,98,342
3959,1,23,3,0,1,15,27,1,0,3,20,42,28,164,6,1,171,126,297
3960,4,131,3,3,2,52,91,3,4,4,39,33,70,439,8,0,447,153,600
3961,3,89,4,0,3,42,103,2,3,1,60,48,73,431,2,0,433,167,600
3962,3,95,13,2,2,57,87,1,2,1,33,64,77,437,7,2,446,154,600
3963,3,93,11,1,0,50,72,1,5,3,38,81,53,411,10,0,421,179,600
3964,1,77,10,1,1,27,86,4,3,1,22,49,45,327,12,6,345,155,500
3965,0,71,10,1,3,51,61,4,1,8,42,39,45,336,7,1,344,156,500
3966,0,67,4,0,1,65,67,4,1,0,39,38,40,326,13,2,341,159,500
3967,1,82,4,3,0,36,78,2,2,2,28,61,36,335,2,0,337,170,507
3968,0,155,0,3,2,24,76,6,4,2,43,30,95,440,8,2,450,150,600
3969,5,133,1,1,4,24,98,3,7,5,26,19,71,397,9,1,407,132,539
3970,1,98,1,1,0,18,95,3,7,3,24,25,21,297,8,1,306,207,513
3971,0,17,0,0,0,6,10,3,0,0,2,13,3,54,0,1,55,12,67
3972,2,138,4,1,7,69,74,5,3,2,22,44,77,448,10,1,459,141,600
3973,1,138,12,2,5,52,116,2,2,1,17,52,68,468,1,1,470,130,600
3974,1,126,13,2,5,46,94,3,3,1,38,40,74,446,7,1,454,146,600
3975,0,121,13,4,5,37,95,0,4,1,24,49,87,440,3,1,444,156,600
3976,4,97,20,0,2,47,97,3,2,2,35,47,77,433,5,1,439,161,600
3977,1,132,23,1,7,40,73,3,2,1,21,51,67,422,3,1,426,174,600
3978,3,137,9,0,4,46,93,7,3,4,19,65,75,465,4,0,469,131,600
3979,1,132,11,1,5,47,97,7,2,1,31,32,78,445,6,0,451,149,600
3980,0,145,6,1,5,53,119,4,7,3,19,34,75,471,3,2,476,124,600
3981,3,119,10,2,1,43,102,4,3,3,33,26,93,442,8,1,451,149,600
3982,2,104,9,0,5,56,90,4,3,6,19,56,58,412,5,0,417,183,600
3983,0,133,12,0,4,51,76,2,3,2,34,45,77,439,5,0,444,156,600
3984,1,148,15,0,0,50,107,4,6,2,20,50,59,462,2,1,465,135,600
3985,0,133,14,2,9,61,88,4,1,4,27,56,63,462,3,0,465,135,600
3986,3,111,18,0,5,46,66,6,5,3,34,58,60,415,10,0,425,175,600
3987,4,154,11,0,5,43,84,5,4,3,30,53,62,458,5,1,464,136,600
3988,2,122,12,0,2,29,83,4,4,1,15,61,88,423,8,0,431,169,600
3989,2,102,15,0,3,41,99,3,4,4,24,56,75,428,15,0,443,157,600
3990,5,126,7,0,4,56,86,2,3,2,19,46,73,429,6,0,435,115,550
3991,0,142,11,1,2,36,81,2,3,0,18,43,50,389,9,2,400,150,550
3992,0,102,12,1,1,33,119,2,3,4,16,55,78,426,1,2,429,121,550
3993,1,115,17,0,12,35,63,2,3,2,16,41,63,370,2,0,372,131,503
3994,1,108,8,1,10,57,58,4,3,7,27,63,45,392,9,0,401,199,600
3995,3,87,16,2,7,50,63,7,3,6,37,66,46,393,6,0,399,201,600
3996,3,108,10,2,3,54,74,1,3,9,42,52,39,400,8,2,410,190,600
3997,1,119,6,1,4,56,69,3,8,1,33,60,37,398,10,1,409,191,600
3998,1,87,8,2,5,48,58,2,2,3,30,57,48,351,2,1,354,146,500
3999,2,93,9,0,1,55,51,4,6,5,23,51,37,337,7,0,344,156,500
4000,2,74,9,0,9,36,51,5,2,1,21,51,40,301,6,2,309,146,455
4001,1,145,10,1,9,45,84,6,2,2,20,59,67,451,6,2,459,141,600
4002,1,145,10,1,12,56,65,2,4,4,27,56,59,442,8,3,453,147,600
4003,0,135,7,1,4,64,89,2,2,2,20,47,77,450,5,0,455,145,600
4004,1,101,10,0,10,67,91,3,5,2,24,58,87,459,1,0,460,140,600
4005,1,149,7,0,3,63,82,2,4,1,21,62,63,458,4,0,462,138,600
4006,1,172,8,1,4,56,91,1,2,1,16,50,74,477,3,0,480,120,600
4007,2,143,10,1,8,61,74,2,8,6,22,54,78,469,3,0,472,128,600
4008,2,114,7,0,5,60,82,7,7,2,23,60,68,437,6,0,443,157,600
4009,0,143,5,0,4,62,74,5,5,2,20,48,78,446,1,2,449,140,589
4010,6,88,15,0,5,44,75,3,1,6,40,59,50,392,11,2,405,195,600
4011,2,102,3,1,2,49,68,10,5,4,47,57,48,398,17,1,416,184,600
4012,3,90,12,1,8,45,72,2,1,6,39,61,71,411,9,1,421,179,600
4013,6,98,6,2,3,50,104,5,1,5,29,62,41,412,10,2,424,176,600
4014,2,114,11,0,7,42,83,10,2,3,47,79,49,449,4,1,454,146,600
4015,2,99,5,1,4,47,87,10,3,4,52,53,54,421,11,1,433,167,600
4016,4,124,15,2,1,33,81,10,2,4,32,37,56,401,16,3,420,180,600
4017,0,109,10,1,5,27,71,3,4,7,43,60,31,371,6,2,379,171,550
4018,2,103,4,1,6,39,58,3,1,7,35,56,68,383,6,2,391,109,500
4019,0,114,5,2,5,30,83,6,0,1,24,43,44,357,4,1,362,138,500
4020,3,89,7,0,1,26,65,5,2,6,23,57,44,328,12,1,341,150,491
4021,1,100,7,2,5,26,108,8,5,5,22,41,42,372,6,2,380,220,600
4022,0,117,2,0,2,32,59,5,0,4,25,33,58,337,3,0,340,185,525
4023,4,73,10,0,5,48,81,4,2,7,42,27,57,360,2,2,364,136,500
4024,2,60,7,1,6,39,64,1,2,3,37,22,43,287,8,3,298,107,405
4025,2,69,0,1,3,45,102,5,1,4,36,15,48,331,10,0,341,199,540
4026,0,143,12,1,4,36,81,3,3,0,30,34,44,391,10,0,401,199,600
4027,0,108,10,0,4,23,148,5,1,5,22,26,36,388,6,2,396,204,600
4028,1,92,8,2,4,42,113,4,1,3,31,31,39,371,6,1,378,222,600
4029,1,94,8,0,2,23,95,7,4,6,47,31,38,356,6,2,364,136,500
4030,0,107,13,1,4,36,89,7,2,7,33,22,51,372,4,0,376,130,506
4031,1,108,1,0,1,14,136,3,3,4,44,43,48,406,2,0,408,210,618
4032,0,116,3,1,1,18,108,2,1,5,34,50,75,414,8,1,423,195,618
4033,0,60,4,0,1,38,136,3,1,6,33,13,69,364,7,2,373,242,615
4034,0,0,0,0,0,1,8,1,0,0,0,0,7,17,0,0,17,86,103
4035,0,94,10,1,0,19,119,0,2,2,31,19,39,336,6,0,342,92,434
4036,2,109,19,0,7,56,99,7,4,2,25,55,84,469,5,0,474,126,600
4037,3,125,8,0,3,37,103,1,2,3,28,48,97,458,4,0,462,138,600
4038,2,157,10,0,0,49,106,5,5,3,23,18,86,464,11,1,476,124,600
4039,1,120,4,0,1,54,99,3,5,4,17,47,75,430,7,1,438,162,600
4040,2,161,11,1,4,47,76,4,8,3,22,39,89,467,6,0,473,127,600
4041,1,99,10,1,1,33,99,6,4,1,21,62,76,414,4,0,418,182,600
4042,0,120,11,1,2,63,85,3,6,2,18,50,93,454,4,1,459,141,600
4043,1,125,9,1,3,52,112,9,7,2,16,39,70,446,4,1,451,149,600
4044,2,142,11,0,3,52,126,2,3,0,30,32,67,470,6,2,478,122,600
4045,0,139,21,3,3,55,87,5,5,0,32,40,81,471,3,2,476,124,600
4046,2,133,10,0,1,50,86,5,2,2,21,37,104,453,2,1,456,144,600
4047,0,134,12,0,3,44,87,1,5,0,24,43,102,455,3,0,458,142,600
4048,1,136,11,0,4,48,90,3,5,2,19,52,87,458,1,2,461,139,600
4049,1,131,19,0,5,48,102,5,3,2,18,45,69,448,4,0,452,148,600
4050,3,127,16,1,1,39,93,3,9,0,27,51,58,428,2,0,430,175,605
4051,1,141,7,0,1,39,96,5,5,2,26,62,75,460,4,1,465,140,605
4052,1,122,12,1,3,43,107,5,5,2,23,43,83,450,8,0,458,147,605
4054,1,151,6,0,1,49,82,3,4,2,22,61,80,462,2,1,465,135,600
4055,1,134,14,0,1,46,82,7,6,4,14,59,96,464,1,0,465,135,600
4056,2,114,8,1,8,37,103,3,5,1,14,63,90,449,6,3,458,142,600
4057,1,122,7,2,3,54,92,2,4,2,22,74,88,473,6,1,480,120,600
4058,2,143,8,0,2,37,123,3,4,1,22,50,62,457,8,0,465,135,600
4059,0,134,7,0,1,40,88,2,3,1,19,60,82,437,2,1,440,160,600
4060,2,136,5,0,3,44,102,3,4,0,24,53,97,473,2,1,476,124,600
4061,1,130,13,1,3,52,121,6,2,1,10,61,64,465,4,0,469,131,600
4062,0,130,6,0,0,26,79,0,0,4,16,78,75,414,4,3,421,129,550
4063,2,113,7,1,1,42,83,2,5,1,11,49,67,384,2,4,390,131,521
4064,2,111,12,1,3,47,75,4,4,3,23,57,64,406,4,2,412,88,500
4065,1,112,8,2,1,34,88,4,9,1,23,49,57,389,5,1,395,105,500
4066,6,115,8,0,0,40,59,3,1,4,15,71,60,382,5,2,389,111,500
4067,1,68,3,1,0,40,68,3,1,0,21,61,53,320,8,0,328,94,422
4068,1,74,2,0,3,22,63,2,3,4,15,23,48,260,2,1,263,76,339
4069,0,21,4,0,3,3,23,1,0,1,6,39,8,109,3,1,113,220,333
4070,1,15,0,0,2,5,23,1,0,0,5,33,3,88,0,0,88,160,248
4071,1,107,6,0,1,34,116,2,7,7,27,38,83,429,7,4,440,160,600
4073,6,92,11,1,6,35,118,5,7,5,36,33,84,439,3,2,444,156,600
4074,0,101,12,0,3,57,106,6,4,3,34,38,65,429,5,3,437,163,600
4076,1,85,14,1,2,49,118,6,0,5,20,54,79,434,7,0,441,159,600
4077,1,101,13,1,1,42,119,9,2,2,35,33,56,415,5,1,421,129,550
4078,0,79,8,0,0,35,93,13,0,3,28,35,56,350,8,3,361,139,500
4079,0,69,19,0,1,45,89,4,6,3,29,41,49,355,2,1,358,119,477
4080,1,97,9,1,2,47,147,13,4,6,53,51,24,455,3,2,460,151,611
4081,3,39,4,1,4,50,89,3,5,6,38,31,24,297,5,1,303,121,424
4082,1,61,3,0,3,28,96,7,4,11,22,55,38,329,4,3,336,112,448
4083,3,57,1,2,0,24,106,6,2,3,14,54,48,320,3,2,325,114,439
4084,1,35,3,0,2,16,69,6,0,2,28,30,24,216,6,0,222,112,334
4085,2,59,2,1,4,46,92,12,1,10,31,35,53,348,6,5,359,150,509
4086,3,106,3,2,1,49,82,8,3,7,26,64,45,399,1,0,400,200,600
4087,2,90,7,2,0,56,90,2,3,5,37,69,51,414,6,1,421,179,600
4088,2,87,5,2,1,46,83,6,2,3,44,55,70,406,2,2,410,190,600
4089,1,80,8,0,1,57,75,5,2,0,33,51,44,357,6,1,364,136,500
4090,2,88,6,0,1,42,84,3,3,6,24,47,56,362,6,3,371,129,500
4091,0,62,10,2,2,45,91,2,0,5,25,51,37,332,8,1,341,159,500
4092,2,78,8,2,0,45,62,3,1,5,22,40,50,318,2,0,320,138,458
4093,1,73,5,0,4,34,128,2,2,2,30,22,113,416,6,3,425,131,556
4094,1,74,1,0,1,41,67,1,5,2,57,30,116,396,4,1,401,154,555
4095,2,51,5,1,4,21,87,4,1,1,14,14,37,242,7,2,251,99,350
4096,1,37,1,0,1,16,88,4,1,2,15,36,31,233,5,0,238,96,334
4097,0,17,5,0,0,8,10,0,0,1,6,10,26,83,2,0,85,46,131
4098,0,11,0,0,2,4,84,0,1,0,30,16,29,177,4,0,181,90,271
4099,1,137,0,1,3,28,108,2,2,3,13,59,81,438,3,1,442,158,600
4100,1,120,0,2,3,37,86,3,4,1,15,78,83,433,5,0,438,162,600
4101,1,137,1,1,4,33,75,3,3,3,14,61,96,432,4,0,436,164,600
4102,1,147,2,1,1,33,79,3,3,4,7,49,91,421,2,0,423,177,600
4103,0,132,1,2,5,36,95,3,5,1,6,59,79,424,0,0,424,176,600
4104,1,156,0,1,3,31,90,4,4,4,22,54,92,462,6,2,470,130,600
4105,0,127,1,0,2,38,71,4,1,2,10,67,81,404,3,0,407,193,600
4106,0,139,1,1,4,23,94,2,5,2,14,49,90,424,3,1,428,172,600
4107,1,148,4,1,2,37,71,1,3,0,7,53,81,409,3,0,412,188,600
4108,1,132,0,0,2,28,108,1,4,1,15,56,102,450,7,0,457,143,600
4109,2,138,3,0,5,33,71,5,8,1,19,51,78,414,1,1,416,184,600
4110,1,128,2,0,5,26,89,3,6,2,11,63,98,434,2,1,437,163,600
4111,1,147,0,0,5,30,85,3,2,1,11,68,99,452,0,0,452,148,600
4112,0,118,0,2,5,38,107,2,4,1,14,57,104,452,4,0,456,144,600
4113,1,132,1,0,3,36,82,5,4,2,14,54,92,426,3,0,429,171,600
4114,0,134,1,1,2,40,81,4,4,2,11,76,71,427,4,0,431,169,600
4115,2,127,2,0,4,42,81,2,4,1,13,70,84,432,1,0,433,167,600
4116,4,141,0,1,3,28,81,5,3,1,9,82,70,428,6,0,434,166,600
4117,1,134,1,1,1,24,80,2,2,0,12,53,112,423,3,0,426,174,600
4118,1,117,2,0,4,33,102,5,2,0,16,63,74,419,1,1,421,179,600
4119,0,140,2,2,3,35,90,2,3,0,8,75,65,425,2,1,428,172,600
4120,0,146,2,3,2,47,81,2,5,1,15,49,89,442,0,0,442,158,600
4121,0,136,1,0,3,28,85,5,5,4,13,66,83,429,2,0,431,169,600
4122,1,143,1,0,7,35,75,5,2,0,18,70,71,428,3,0,431,169,600
4123,1,143,2,2,3,30,90,3,4,2,17,45,83,425,3,0,428,172,600
4124,0,135,0,1,2,23,74,6,2,2,22,54,107,428,2,1,431,169,600
4125,2,136,0,0,6,36,97,3,3,2,18,74,78,455,3,0,458,142,600
4126,0,142,2,0,5,31,54,2,4,2,12,50,78,382,1,0,383,117,500
4127,0,128,0,0,3,19,115,1,2,2,6,36,80,392,2,0,394,106,500
4128,1,109,1,1,1,24,97,2,3,1,7,32,80,359,2,2,363,104,467
4129,1,192,1,3,4,37,76,5,4,1,14,57,81,476,0,1,477,123,600
4130,0,135,1,1,3,35,91,4,6,5,7,62,68,418,4,0,422,178,600
4131,1,158,1,1,2,34,79,3,7,3,8,75,81,453,2,0,455,145,600
4132,1,161,1,1,6,34,66,10,4,2,13,84,83,466,2,0,468,132,600
4133,0,148,2,0,4,31,89,6,6,0,18,83,75,462,1,1,464,136,600
4134,2,202,1,0,1,21,61,5,6,3,13,58,64,437,6,0,443,157,600
4135,4,156,0,0,1,35,76,9,3,3,11,79,88,465,3,0,468,132,600
4136,2,145,2,1,3,33,83,3,2,0,21,62,80,437,3,1,441,157,598
4137,0,179,0,1,1,21,85,2,7,2,14,64,85,461,0,0,461,139,600
4138,1,158,1,0,2,26,68,6,4,4,14,71,86,441,4,0,445,155,600
4139,2,163,2,0,6,25,70,8,9,3,13,87,75,463,4,1,468,132,600
4140,2,142,1,1,6,40,93,11,5,0,14,46,89,450,3,0,453,147,600
4141,1,172,1,2,5,35,76,3,3,7,19,80,62,466,4,0,470,130,600
4142,0,178,0,0,2,31,94,4,3,0,17,60,73,462,2,1,465,135,600
4143,1,158,2,0,2,41,83,1,4,3,14,49,78,436,3,0,439,161,600
4144,1,158,1,0,7,32,82,3,5,4,12,80,77,462,1,1,464,136,600
4145,1,117,1,1,3,38,79,4,6,2,12,48,60,372,2,0,374,126,500
4146,0,140,1,0,2,19,72,4,5,2,15,51,77,388,1,0,389,111,500
4147,1,121,1,0,0,27,66,2,6,0,13,71,63,371,4,0,375,98,473
4148,2,176,0,0,1,23,79,2,5,4,17,71,69,449,1,2,452,148,600
4149,2,142,0,0,4,38,92,0,2,4,21,66,99,470,2,0,472,128,600
4150,0,136,0,1,2,33,97,1,2,1,10,65,105,453,0,1,454,146,600
4151,1,152,1,3,4,32,87,4,5,2,19,52,107,469,2,2,473,127,600
4152,2,149,3,1,5,23,102,1,10,1,18,60,85,460,2,1,463,137,600
4153,1,145,2,0,3,31,108,1,7,1,17,52,89,457,2,1,460,140,600
4154,0,136,4,1,5,32,96,4,5,5,18,59,104,469,1,0,470,130,600
4155,0,147,3,2,5,36,99,5,5,0,20,67,78,467,3,0,470,130,600
4156,0,148,0,1,1,45,98,1,6,3,11,57,99,470,0,1,471,129,600
4157,1,171,2,1,6,29,67,3,8,1,13,75,80,457,1,0,458,142,600
4158,0,151,2,1,7,25,69,5,7,5,18,53,109,452,1,0,453,147,600
4159,1,157,1,0,3,39,81,0,8,4,13,56,110,473,1,0,474,126,600
4160,0,144,2,2,6,43,74,5,3,2,12,63,100,456,3,2,461,139,600
4161,2,153,4,0,6,32,90,3,6,0,19,54,78,447,1,0,448,152,600
4162,3,140,1,0,2,39,93,6,2,1,17,62,99,465,1,0,466,134,600
4163,0,155,2,1,5,40,72,3,4,3,11,53,104,453,4,0,457,143,600
4164,0,143,0,0,3,35,69,4,4,1,15,47,82,403,2,1,406,94,500
4165,1,120,1,0,1,27,68,2,7,3,10,53,79,372,3,0,375,115,490
4166,1,148,1,0,4,26,91,2,5,0,6,95,77,456,0,0,456,144,600
4167,0,140,1,0,4,23,77,3,6,3,8,86,91,442,3,0,445,155,600
4168,1,134,3,1,4,34,87,3,8,1,12,79,91,458,1,0,459,141,600
4169,1,153,1,0,2,35,80,3,11,0,10,87,67,450,0,1,451,149,600
4170,0,154,1,1,2,30,74,3,5,1,17,79,84,451,1,0,452,148,600
4171,0,120,1,0,6,32,72,4,7,2,10,85,74,413,3,0,416,184,600
4172,0,125,5,2,8,48,78,3,6,0,8,70,92,445,2,0,447,153,600
4173,0,127,1,0,7,35,66,1,4,4,21,87,85,438,0,0,438,162,600
4174,2,133,1,2,2,22,69,3,3,1,9,91,85,423,3,0,426,174,600
4175,1,110,0,1,1,29,97,3,4,0,12,113,86,457,2,0,459,141,600
4176,2,164,1,0,1,30,80,3,2,1,14,88,76,462,5,0,467,133,600
4177,1,120,1,1,3,33,91,3,3,2,12,105,60,435,2,0,437,163,600
4178,0,128,3,1,2,21,87,3,2,4,17,79,92,439,4,0,443,157,600
4179,1,137,0,0,2,34,81,3,2,4,10,72,107,453,2,0,455,145,600
4180,2,136,1,0,3,21,80,8,9,2,5,95,67,429,2,0,431,169,600
4181,0,119,2,2,2,36,68,5,2,1,7,106,81,431,2,0,433,167,600
4182,0,149,1,1,1,24,63,4,3,0,8,108,69,431,1,1,433,167,600
4183,1,130,1,0,8,31,76,5,7,2,9,83,74,427,3,0,430,170,600
4184,0,124,0,2,4,27,78,2,7,3,9,83,79,418,3,1,422,178,600
4185,0,132,4,0,1,31,89,2,4,0,13,107,58,441,5,0,446,154,600
4186,1,135,0,1,1,29,81,5,3,3,9,89,82,439,3,0,442,158,600
4187,0,136,3,0,2,27,76,2,4,3,8,110,68,439,2,1,442,158,600
4188,2,118,3,0,7,33,70,2,7,2,13,94,86,437,1,0,438,162,600
4189,1,126,8,0,4,26,63,3,4,3,16,86,93,433,1,1,435,165,600
4190,0,129,2,1,0,34,78,2,8,4,11,74,86,429,1,2,432,168,600
4191,1,119,3,1,4,28,66,3,4,2,8,92,79,410,4,0,414,186,600
4192,0,109,1,0,3,28,63,3,2,1,13,77,83,383,0,0,383,117,500
4193,0,137,0,0,3,26,65,7,4,0,12,62,71,387,3,0,390,132,522
4194,1,114,2,0,5,50,68,1,3,0,15,99,73,431,8,0,439,161,600
4195,2,122,2,2,1,29,74,2,3,1,18,88,75,419,2,0,421,179,600
4196,2,125,1,0,3,43,69,4,2,2,22,79,83,435,4,1,440,160,600
4197,3,103,2,0,4,46,73,4,4,4,19,100,71,433,3,0,436,164,600
4198,4,144,2,2,2,35,67,5,2,3,14,75,65,420,1,1,422,178,600
4199,1,105,1,2,3,27,60,3,4,0,18,64,72,360,1,2,363,137,500
4200,1,97,0,1,1,27,62,2,3,3,16,70,63,346,6,2,354,153,507
4201,0,101,0,4,5,23,85,6,2,4,22,87,67,406,5,0,411,189,600
4202,4,103,1,1,7,26,68,13,8,1,12,107,73,424,1,2,427,173,600
4203,0,125,0,0,4,30,49,4,2,2,17,117,53,403,1,0,404,196,600
4204,1,122,2,1,5,25,66,3,2,2,17,106,66,418,0,2,420,180,600
4205,0,87,2,1,2,21,52,4,6,1,9,82,51,318,2,0,320,180,500
4206,0,91,0,3,5,24,58,7,6,2,18,73,47,334,1,0,335,165,500
4207,0,90,2,0,3,31,81,5,6,1,7,74,51,351,4,0,355,145,500
4208,0,92,0,2,7,23,61,5,3,4,12,76,42,327,6,0,333,167,500
4209,1,93,1,0,2,17,50,4,2,0,11,73,43,297,0,1,298,158,456
4210,1,45,4,2,2,34,44,4,2,2,16,143,42,341,2,0,343,257,600
4211,1,38,0,1,0,25,61,7,3,4,13,148,39,340,3,2,345,255,600
4212,0,54,0,2,0,25,38,6,3,5,22,137,31,323,5,3,331,269,600
4213,2,45,2,1,0,24,55,5,0,2,20,152,40,348,7,0,355,245,600
4214,1,70,0,0,2,23,41,4,0,4,5,129,40,319,5,2,326,274,600
4215,1,49,6,1,3,27,54,8,2,2,14,143,38,348,7,2,357,243,600
4216,1,52,0,1,1,31,47,6,2,0,11,157,41,350,4,1,355,245,600
4217,1,53,2,0,1,23,48,9,2,1,13,130,44,327,6,0,333,267,600
4219,0,62,0,1,2,17,38,4,0,2,8,144,36,314,4,0,318,282,600
4220,1,59,2,2,2,23,53,6,2,2,19,130,50,351,4,1,356,244,600
4221,2,42,0,2,4,29,39,7,0,2,7,152,33,319,7,0,326,274,600
4222,1,49,0,0,1,25,30,7,1,8,12,140,50,324,4,3,331,269,600
4223,2,46,3,0,1,33,48,4,1,2,14,141,32,327,4,0,331,269,600
4224,1,47,1,2,5,30,34,1,2,2,10,152,50,337,5,0,342,258,600
4225,3,46,0,0,3,26,40,7,3,1,10,137,30,306,8,0,314,236,550
4226,1,53,0,1,0,19,42,9,4,4,6,116,43,298,3,3,304,196,500
4227,3,46,1,1,2,22,39,8,4,0,10,117,30,283,4,0,287,213,500
4228,1,51,2,0,2,24,48,3,3,2,21,116,46,319,4,0,323,202,525
4229,2,123,0,0,4,33,98,5,3,0,11,78,73,430,4,1,435,165,600
4230,4,122,0,0,9,21,102,2,2,4,14,89,92,461,3,1,465,135,600
4231,3,107,0,0,7,41,86,1,10,3,17,98,68,441,4,0,445,155,600
4232,1,122,2,1,4,36,75,4,5,0,14,95,60,419,5,1,425,175,600
4233,1,117,3,1,5,29,74,2,5,3,11,81,79,411,8,0,419,181,600
4234,1,114,0,0,6,28,84,4,6,1,8,96,50,398,6,0,404,196,600
4235,1,121,0,1,6,30,59,5,5,1,12,103,64,408,8,1,417,183,600
4236,0,132,2,1,7,34,72,8,10,2,19,90,64,441,3,1,445,155,600
4237,2,118,0,1,7,30,83,7,8,2,14,101,58,431,1,0,432,168,600
4238,0,95,0,0,2,29,80,6,1,5,16,100,53,387,1,1,389,161,550
4239,3,115,2,1,3,33,88,7,5,1,14,85,47,404,2,1,407,109,516
4240,4,112,4,3,3,39,69,5,4,1,10,102,63,419,4,0,423,177,600
4241,3,120,0,0,6,26,57,8,8,2,20,110,62,422,2,0,424,176,600
4242,0,120,2,1,0,37,48,10,1,9,19,109,67,423,3,2,428,172,600
4243,3,113,2,2,8,47,61,7,2,6,8,105,73,437,2,1,440,160,600
4244,0,125,2,1,3,41,71,6,3,7,9,87,66,421,6,0,427,173,600
4245,0,117,0,2,3,34,84,7,10,4,20,81,66,428,1,0,429,171,600
4246,2,137,0,1,3,40,57,5,4,0,17,95,62,423,3,1,427,173,600
4247,0,127,0,0,1,30,73,4,4,1,18,109,65,432,2,0,434,166,600
4248,2,97,3,2,4,33,53,11,8,1,23,128,71,436,1,0,437,163,600
4249,1,116,1,0,2,44,62,5,4,5,13,100,58,411,1,2,414,186,600
4250,2,120,0,1,2,44,62,6,5,3,22,107,68,442,4,1,447,153,600
4251,0,89,0,1,3,36,58,4,5,2,13,99,56,366,1,0,367,133,500
4252,2,102,1,0,6,30,53,4,6,1,9,94,66,374,1,2,377,123,500
4253,0,96,1,1,4,35,64,4,3,3,7,77,55,350,0,0,350,150,500
4254,1,103,1,1,3,20,57,5,3,3,10,77,62,346,0,0,346,154,500
4255,0,98,1,0,8,26,67,4,3,3,18,86,34,348,5,0,353,163,516
4256,0,119,4,0,6,25,66,7,1,1,16,98,76,419,3,1,423,177,600
4257,3,120,1,0,2,21,83,1,3,4,8,102,92,440,0,1,441,159,600
4258,3,131,3,2,1,20,76,3,3,5,14,78,94,433,3,0,436,164,600
4259,2,96,3,0,1,27,75,11,5,5,16,87,90,418,4,1,423,177,600
4260,0,135,2,0,3,25,79,2,5,3,6,85,79,424,2,0,426,174,600
4261,0,113,1,1,4,31,73,5,3,0,9,72,69,381,3,0,384,166,550
4262,1,118,1,0,4,21,55,6,4,2,18,96,79,405,4,0,409,141,550
4263,2,99,2,0,11,18,66,4,7,1,14,78,74,376,1,0,377,161,538
4264,2,37,0,1,1,11,91,4,0,3,10,58,47,265,1,2,268,119,387
4265,0,14,0,1,1,3,20,2,1,4,4,15,44,109,0,0,109,55,164
4266,0,153,2,0,3,36,89,2,3,1,19,74,80,462,2,0,464,136,600
4267,0,147,0,1,2,47,83,5,3,1,16,76,57,438,3,0,441,159,600
4268,1,124,1,0,5,42,80,6,5,2,9,104,64,443,1,1,445,155,600
4269,1,146,1,3,5,37,64,7,3,3,14,91,69,444,1,0,445,155,600
4270,1,145,1,0,9,33,72,4,6,0,21,93,72,457,3,1,461,139,600
4271,0,162,1,1,10,45,75,0,8,1,12,60,80,455,1,1,457,143,600
4272,1,154,3,0,5,31,77,4,8,1,20,70,73,447,1,1,449,151,600
4273,0,152,4,0,3,45,76,3,2,2,12,96,81,476,2,0,478,122,600
4281,2,64,0,0,1,25,48,3,5,2,21,111,56,338,1,1,340,160,500
4282,0,97,2,1,8,35,54,6,4,5,25,64,60,361,1,0,362,138,500
4283,2,118,1,0,1,17,69,3,11,2,33,65,53,375,4,0,379,121,500
4284,0,114,0,0,2,31,45,1,1,3,14,73,55,339,3,0,342,158,500
4285,1,98,1,2,2,18,48,4,4,0,21,76,40,315,2,0,317,156,473
4286,1,91,0,2,3,22,70,5,8,1,39,128,54,424,5,0,429,171,600
4301,0,137,1,1,4,48,75,1,7,2,15,86,94,471,1,1,473,127,600
4302,0,172,2,1,5,32,72,7,4,0,12,94,69,470,0,0,470,130,600
4303,0,120,1,0,2,33,77,3,4,1,20,90,92,443,3,0,446,154,600
4304,1,156,0,1,6,42,68,4,3,1,9,90,80,461,6,0,467,133,600
4305,1,116,1,0,2,31,67,5,3,3,15,68,102,414,1,0,415,100,515
4306,0,181,1,1,8,41,74,4,5,2,8,70,78,473,4,0,477,123,600
4307,1,135,1,2,9,30,64,6,5,3,11,98,92,457,2,1,460,140,600
4308,1,146,1,0,3,39,76,2,5,2,12,77,94,458,1,1,460,140,600
4309,0,169,0,0,3,39,67,4,4,3,13,89,79,470,1,1,472,128,600
4321,2,102,3,0,2,28,104,3,4,2,19,89,61,419,3,1,423,104,527
4322,0,8,0,0,1,3,16,1,1,0,1,6,18,55,1,0,56,32,88
4323,0,52,0,0,1,16,34,6,0,1,15,25,25,175,2,1,178,102,280
4324,0,61,0,2,5,19,56,5,0,0,21,45,85,299,5,0,304,123,427
4325,0,1,0,0,0,1,4,1,0,0,0,0,2,9,1,0,10,4,14
4326,1,114,3,0,3,34,119,3,5,4,7,54,106,453,4,0,457,143,600
4327,0,134,2,0,2,27,97,2,0,7,5,40,138,454,0,1,455,145,600
4328,1,136,0,0,1,30,101,2,4,5,8,44,134,466,1,0,467,133,600
4329,0,119,2,1,6,38,102,4,7,3,12,56,102,452,3,0,455,145,600
4330,0,119,1,0,1,48,101,5,7,5,13,52,116,468,3,0,471,129,600
4331,2,113,0,0,6,42,88,2,5,4,4,61,127,454,3,1,458,142,600
4332,1,124,1,0,3,26,100,2,7,1,18,63,92,438,2,1,441,159,600
4333,0,133,1,0,3,37,97,4,5,0,12,63,95,450,2,3,455,145,600
4334,1,107,2,1,1,31,94,3,1,5,6,70,128,450,6,1,457,143,600
4335,2,124,3,0,3,23,115,1,3,7,4,47,115,447,2,0,449,151,600
4336,0,105,3,1,0,37,105,3,6,2,4,65,105,436,6,1,443,157,600
4337,0,101,2,1,1,24,97,0,5,1,7,62,90,391,3,0,394,106,500
4338,1,113,2,1,5,28,87,1,4,1,10,53,117,423,7,0,430,150,580
4339,1,139,0,0,5,28,81,3,4,2,7,57,124,451,5,1,457,143,600
4340,0,161,2,0,6,25,91,6,8,4,5,61,107,476,2,0,478,122,600
4341,1,158,1,0,3,31,95,6,4,2,8,55,117,481,2,0,483,117,600
4342,0,137,2,2,3,36,81,2,2,1,6,65,106,443,1,2,446,154,600
4343,2,164,1,0,2,32,88,0,0,4,10,65,120,488,5,0,493,107,600
4361,2,111,3,2,0,32,82,6,1,2,17,82,106,446,7,0,453,147,600
4362,0,102,1,0,4,41,61,2,1,3,11,81,132,439,1,0,440,160,600
4363,0,141,2,0,3,31,85,2,4,5,14,64,85,436,2,1,439,161,600
4364,1,127,0,0,6,28,80,3,11,1,9,96,86,448,1,0,449,151,600
4053,1,108,20,1,3,50,84,5,2,1,11,56,69,411,3,1,415,190,605
4072,1,74,16,0,0,54,103,6,9,3,47,41,89,443,5,1,449,151,600
4075,4,85,16,2,5,46,110,2,1,1,42,54,71,439,7,1,447,153,600
4218,1,60,5,0,2,36,42,4,3,2,16,121,39,331,6,0,337,263,600
4274,1,154,2,0,4,40,91,2,5,1,9,84,85,478,2,0,480,120,600
4275,0,157,1,2,2,25,96,4,2,1,18,65,99,472,1,0,473,109,582
4276,1,104,1,3,5,33,63,6,10,1,42,87,58,414,4,0,418,182,600
4277,1,125,2,0,4,35,90,3,5,3,24,83,53,428,0,0,428,172,600
4278,1,128,0,1,6,37,64,3,8,0,19,101,64,432,2,0,434,166,600
4279,0,143,3,0,2,48,75,7,1,0,24,96,49,448,4,0,452,148,600
4280,0,115,0,1,5,42,62,2,12,1,28,93,58,419,3,0,422,178,600
4287,0,97,0,0,8,31,46,7,4,1,36,113,66,409,4,0,413,187,600
4288,0,96,2,0,3,36,75,4,2,3,31,109,33,394,4,2,400,200,600
4289,1,98,1,0,6,43,64,10,2,5,18,127,42,417,5,0,422,178,600
4290,0,94,1,3,2,38,61,5,3,0,33,105,39,384,4,0,388,176,564
4291,1,114,1,0,5,29,73,9,4,3,22,111,74,446,3,0,449,151,600
4292,0,123,2,2,6,35,59,4,1,1,20,105,83,441,3,0,444,156,600
4293,2,140,1,0,6,47,64,5,0,1,24,109,68,467,2,0,469,131,600
4294,1,137,2,2,3,36,63,6,4,1,13,90,96,454,3,1,458,142,600
4295,1,128,2,0,5,38,57,8,2,6,18,94,68,427,6,0,433,167,600
4296,0,149,0,0,5,24,80,5,4,6,30,97,52,452,4,0,456,144,600
4297,0,112,3,0,4,29,63,4,4,2,29,90,61,401,3,0,404,141,545
4298,1,117,1,0,8,22,74,2,4,3,38,54,69,393,3,2,398,102,500
4299,0,132,3,1,7,25,78,4,2,0,32,43,62,389,2,1,392,108,500
4300,0,130,2,1,4,25,49,6,1,1,31,45,74,369,0,0,369,92,461
4310,0,159,0,2,10,30,63,9,8,6,13,90,70,460,1,0,461,139,600
4311,3,130,0,0,5,30,80,4,7,1,16,49,66,391,2,0,393,107,500
4312,1,149,1,0,5,29,58,1,7,1,16,61,69,398,0,0,398,102,500
4313,1,125,0,3,7,27,77,3,2,1,14,71,70,401,2,0,403,97,500
4314,1,123,2,0,5,29,78,0,6,1,13,60,64,382,0,0,382,118,500
4315,0,152,1,0,6,27,64,4,6,5,14,61,100,440,1,2,443,117,560
4316,1,128,2,0,6,37,74,4,8,5,9,109,56,439,0,0,439,161,600
4317,1,119,0,0,2,25,108,6,4,1,29,93,75,463,3,1,467,133,600
4318,1,110,3,0,5,36,80,8,13,2,13,128,50,449,4,1,454,146,600
4319,1,101,1,3,4,35,58,3,14,4,28,129,46,427,6,0,433,167,600
4320,0,121,1,0,4,36,74,3,3,0,23,115,38,418,1,0,419,131,550
4344,0,139,0,1,1,32,71,1,1,5,13,55,118,437,3,0,440,110,550
4345,0,117,1,0,0,32,87,3,8,6,8,55,101,418,2,0,420,130,550
4346,0,129,1,0,6,23,67,3,2,4,5,49,94,383,2,2,387,103,490
4347,2,114,0,0,4,38,74,3,5,3,12,99,69,423,7,1,431,169,600
4348,1,150,3,0,5,44,72,5,4,2,16,79,85,466,4,0,470,130,600
4349,2,113,0,2,4,45,73,6,5,6,18,93,84,451,4,0,455,145,600
4350,2,82,3,1,0,44,56,7,0,1,19,80,76,371,3,1,375,125,500
4351,1,109,1,2,1,42,61,5,4,7,15,67,75,390,3,2,395,105,500
4352,0,114,0,1,0,28,58,8,6,3,19,61,64,362,0,0,362,110,472
4353,2,141,2,0,6,35,102,2,3,1,8,74,115,491,3,0,494,119,613
4354,1,102,1,0,1,26,39,5,2,9,13,86,63,348,2,0,350,100,450
4355,0,77,0,0,3,35,44,8,1,1,15,101,48,333,0,0,333,117,450
4356,0,104,3,0,3,30,42,6,3,2,10,80,55,338,3,1,342,96,438
4357,0,75,1,2,3,31,68,9,3,3,11,142,68,416,5,1,422,178,600
4358,2,84,1,0,2,38,105,3,2,3,9,118,56,423,6,0,429,171,600
4359,1,80,0,1,1,36,56,5,1,1,10,124,48,364,4,0,368,132,500
4360,1,78,1,0,3,38,67,2,4,0,10,120,48,372,7,0,379,138,517
4365,0,129,3,1,3,32,88,3,3,3,10,71,97,443,1,0,444,156,600
4366,0,115,0,1,4,32,54,6,3,0,18,72,87,392,4,1,397,103,500
4367,0,115,0,0,3,24,87,3,3,0,12,72,85,404,3,0,407,99,506
4368,1,98,0,0,4,32,85,2,16,3,19,99,76,435,7,1,443,157,600
4369,1,96,0,2,1,41,76,8,1,5,20,92,74,417,4,0,421,179,600
4370,2,98,1,1,6,44,67,2,6,5,29,94,68,423,10,1,434,166,600
4371,3,64,0,0,0,34,75,1,7,3,16,107,83,393,5,1,399,201,600
4372,1,94,1,0,0,34,79,8,3,7,28,105,67,427,4,1,432,168,600
4373,0,98,0,1,1,26,60,5,6,6,22,95,59,379,3,0,382,168,550
4374,2,108,5,0,4,34,70,2,4,3,21,77,54,384,5,0,389,161,550
4375,2,83,1,2,2,32,73,2,3,3,20,98,57,378,2,0,380,170,550
4376,3,63,0,2,1,27,76,1,5,4,22,86,62,352,3,1,356,181,537
4377,0,115,3,2,3,39,67,1,6,0,9,72,88,405,1,1,407,193,600
4378,1,117,1,1,3,46,89,1,3,3,11,80,90,446,4,0,450,150,600
4379,0,125,0,0,4,38,68,4,4,4,9,104,59,419,6,3,428,172,600
4380,1,133,1,0,5,35,72,4,1,6,14,58,64,394,4,1,399,151,550
4381,1,101,2,0,2,35,65,3,2,4,11,68,82,376,1,0,377,143,520
4382,2,129,0,2,4,33,73,3,4,2,14,79,99,444,5,1,450,150,600
4383,3,98,4,0,1,36,50,4,2,2,8,93,62,363,1,0,364,136,500
4384,1,107,3,1,2,29,54,3,1,4,12,71,70,358,6,2,366,134,500
4385,1,93,4,0,2,23,45,4,3,5,9,76,74,339,4,1,344,156,500
4386,1,137,1,0,2,39,70,10,5,3,18,49,72,407,2,1,410,138,548
4387,1,103,0,0,1,55,70,3,2,2,12,130,68,447,3,0,450,150,600
4388,2,118,1,1,1,42,67,5,8,2,24,108,48,427,3,1,431,169,600
4389,1,106,2,1,5,56,66,2,3,1,16,120,59,438,4,2,444,156,600
4390,0,105,1,0,1,41,53,1,5,1,13,146,69,436,1,1,438,162,600
4391,1,120,3,1,2,32,58,8,2,2,22,129,63,443,2,0,445,155,600
4392,0,95,0,0,1,42,50,7,3,2,21,126,61,408,3,0,411,189,600
4393,0,104,2,2,3,44,76,2,6,0,19,115,68,441,1,1,443,157,600
4394,1,130,0,0,1,35,76,6,4,0,21,107,73,454,3,0,457,143,600
4395,0,111,0,0,4,19,51,2,3,1,24,88,52,355,2,0,357,157,514
4396,1,106,0,1,4,35,49,2,2,0,29,74,55,358,3,0,361,139,500
4397,1,82,1,0,1,36,61,5,4,1,15,91,44,342,3,0,345,155,500
4398,1,97,1,1,3,49,64,4,5,1,23,87,52,388,6,0,394,106,500
4399,0,96,1,1,1,51,81,6,0,2,37,68,88,432,1,1,434,166,600
4400,2,97,2,0,2,42,59,3,4,1,34,101,52,399,5,0,404,196,600
4401,1,90,1,0,2,42,71,6,1,1,44,90,55,404,2,0,406,194,600
4402,0,85,0,0,5,31,93,2,2,1,57,76,72,424,3,1,428,172,600
4403,3,121,1,0,2,37,81,6,6,1,48,71,54,431,2,0,433,182,615
4404,3,113,3,0,3,40,62,0,4,3,24,73,106,434,4,2,440,160,600
4405,1,110,3,0,3,45,68,5,4,1,23,98,55,416,3,1,420,180,600
4406,0,103,2,1,3,55,66,7,0,2,19,98,74,430,1,0,431,169,600
4407,1,121,0,0,1,31,66,7,6,3,18,124,56,434,2,0,436,164,600
4408,1,125,1,1,4,39,64,5,3,1,21,117,48,430,3,1,434,166,600
4409,0,107,1,0,5,47,82,4,5,2,19,96,81,449,2,1,452,148,600
4410,2,125,1,2,3,32,70,0,3,3,32,77,89,439,0,0,439,161,600
4411,2,112,2,1,1,48,63,6,9,2,28,85,76,435,2,1,438,162,600
4412,1,97,1,0,6,41,49,3,2,2,27,80,64,373,3,0,376,125,501
4413,0,111,3,3,1,43,66,4,4,2,25,114,50,426,3,0,429,171,600
4414,0,110,2,1,6,42,60,3,5,4,38,107,64,442,1,0,443,157,600
4415,1,94,0,1,3,40,72,5,5,8,25,108,60,422,4,0,426,174,600
4416,1,91,0,2,1,40,46,4,2,0,35,86,49,357,4,1,362,138,500
4417,0,91,3,0,3,38,61,1,3,6,21,101,47,375,4,0,379,136,515
4418,2,80,0,1,2,39,78,5,3,2,12,137,54,415,8,0,423,177,600
4419,0,99,1,1,1,31,78,2,4,3,17,129,54,420,1,1,422,178,600
4420,3,93,0,1,5,34,62,7,4,1,17,132,49,408,3,0,411,189,600
4421,0,73,1,0,1,21,71,4,3,2,20,96,43,335,2,1,338,162,500
4422,0,81,1,0,3,22,59,6,4,3,10,110,38,337,5,0,342,158,500
4423,0,90,0,0,3,24,62,2,7,2,11,97,48,346,5,0,351,155,506
4424,2,88,0,0,1,20,54,5,1,1,9,110,51,342,6,0,348,152,500
4425,1,80,0,0,1,23,52,4,4,0,17,84,71,337,5,0,342,158,500
4426,3,94,0,1,1,19,67,3,5,1,27,97,56,374,4,0,378,149,527
4427,3,131,0,0,3,29,102,0,2,1,25,57,80,433,3,1,437,175,612
4428,0,13,0,0,2,5,34,0,0,1,2,12,14,83,1,0,84,40,124
4429,4,67,2,0,3,36,72,6,5,2,34,72,51,354,8,1,363,187,550
4430,0,66,0,1,1,38,84,3,2,1,26,85,40,347,3,0,350,170,520
4431,2,125,1,0,2,31,73,7,3,4,16,94,48,406,3,0,409,191,600
4432,1,94,1,0,3,20,78,3,1,2,23,86,38,350,1,0,351,149,500
4433,0,98,2,0,2,22,65,5,6,0,14,95,47,356,2,0,358,142,500
4434,1,91,3,2,7,18,81,1,4,3,21,126,48,406,3,0,409,153,562
4435,1,124,2,1,2,39,64,4,1,2,16,91,82,429,1,1,431,169,600
4436,3,125,1,0,2,40,66,4,6,2,8,82,71,410,5,0,415,185,600
4437,0,121,1,0,6,27,64,1,3,2,18,80,95,418,2,0,420,180,600
4438,1,112,2,2,2,41,102,3,2,1,12,83,86,449,2,2,453,147,600
4439,1,126,2,1,3,39,73,6,5,2,14,107,77,456,3,0,459,141,600
4440,1,136,2,1,3,42,63,3,2,6,19,84,66,428,0,1,429,171,600
4441,0,145,2,0,6,33,100,4,4,2,8,67,92,463,0,1,464,136,600
4442,0,134,2,2,3,31,78,1,5,2,15,72,90,435,5,0,440,160,600
4443,1,120,0,1,6,42,72,3,5,1,16,81,82,430,1,0,431,169,600
4444,2,131,0,2,7,38,63,4,2,5,15,93,65,427,1,0,428,172,600
4445,3,115,0,0,1,37,74,2,4,1,28,95,64,424,4,0,428,122,550
4446,1,113,0,0,4,34,71,2,4,0,14,88,75,406,1,1,408,142,550
4447,2,109,0,0,3,41,63,6,5,3,13,79,79,403,2,1,406,144,550
4448,1,108,1,0,5,38,53,3,2,1,18,98,75,403,3,0,406,144,550
4449,1,127,1,0,6,31,81,1,2,1,17,74,69,411,3,0,414,136,550
4450,0,122,1,1,6,35,67,6,4,1,17,66,73,399,3,0,402,143,545
4451,1,114,0,1,2,27,51,1,5,2,27,95,65,391,1,1,393,207,600
4452,1,116,1,1,2,32,49,2,4,4,13,88,67,380,0,1,381,219,600
4453,1,122,2,1,4,35,72,1,2,5,10,117,62,434,2,2,438,162,600
4454,0,114,3,2,5,33,57,1,5,3,16,96,65,400,6,0,406,194,600
4455,3,101,4,0,2,33,52,3,2,2,11,95,66,374,3,0,377,223,600
4456,2,117,2,2,6,43,67,2,6,1,21,89,49,407,4,0,411,189,600
4457,1,102,1,1,4,36,63,5,4,5,16,116,51,405,7,1,413,187,600
4458,1,128,0,0,2,23,59,2,2,2,7,90,65,381,5,0,386,214,600
4459,1,113,1,1,4,43,50,9,3,2,19,76,65,387,2,0,389,211,600
4460,1,108,2,1,3,41,56,3,4,0,18,110,56,403,3,1,407,193,600
4461,3,109,2,1,6,23,52,4,4,2,11,115,74,406,5,0,411,199,610
4462,1,121,2,0,2,46,63,2,6,2,16,87,71,419,4,1,424,186,610
4463,0,125,1,0,7,26,58,4,4,5,23,89,61,403,3,1,407,204,611
4464,2,122,1,0,3,48,65,4,3,2,14,105,68,437,4,4,445,155,600
4465,0,128,2,0,4,34,57,6,0,4,19,93,83,430,2,3,435,165,600
4466,0,158,1,0,3,37,71,3,6,1,17,80,76,453,4,1,458,142,600
4467,0,103,0,2,5,35,64,2,3,2,13,91,44,364,1,0,365,135,500
4468,3,118,0,1,3,41,45,4,4,6,10,68,50,353,2,0,355,145,500
4469,3,119,0,0,2,32,50,5,3,2,13,79,53,361,3,0,364,136,500
4470,1,144,1,0,3,37,41,2,4,3,12,59,69,376,1,0,377,123,500
4471,0,148,0,0,5,28,73,0,4,2,13,95,59,427,2,0,429,131,560
4472,1,126,1,2,2,29,71,0,3,0,9,79,61,384,4,0,388,112,500
4473,1,134,0,0,7,30,56,2,4,1,13,67,59,374,0,1,375,125,500
4474,0,123,0,0,0,17,36,4,4,2,6,89,62,343,1,1,345,104,449
4475,2,129,1,0,1,31,75,6,13,3,18,90,77,446,1,1,448,152,600
4476,1,141,0,1,7,43,72,5,2,0,22,72,82,448,2,0,450,150,600
4477,2,140,0,0,2,40,76,4,3,0,14,74,91,446,2,0,448,152,600
4478,1,117,1,1,3,24,54,7,4,2,9,69,74,366,5,0,371,129,500
4479,0,139,0,1,3,33,62,1,3,0,5,70,62,379,3,0,382,118,500
4480,0,107,1,1,2,32,76,6,5,1,7,66,77,381,1,0,382,118,500
4481,0,106,0,1,2,42,79,6,4,2,8,55,73,378,4,1,383,117,500
4482,0,113,2,1,1,25,65,5,3,4,14,60,68,361,2,1,364,137,501
4483,4,85,0,1,3,25,55,3,1,1,17,95,58,348,0,0,348,152,500
4484,2,68,1,0,2,26,56,3,7,0,19,94,57,335,3,0,338,161,499
4485,1,87,0,1,1,20,40,2,3,0,19,89,53,316,5,2,323,177,500
4486,0,78,1,1,1,24,49,4,4,1,11,105,43,322,5,1,328,172,500
4487,0,67,0,0,3,26,45,3,2,2,24,111,70,353,6,1,360,134,494
4488,1,118,7,2,6,32,69,4,5,2,28,64,72,410,4,0,414,160,574
4489,1,68,0,1,1,29,38,8,3,3,17,88,59,316,3,0,319,181,500
4490,1,83,2,1,5,29,39,1,5,2,11,53,65,297,5,2,304,146,450
4491,1,76,1,1,1,24,52,4,3,1,14,69,60,307,3,2,312,138,450
4492,1,88,0,1,1,26,42,5,5,1,22,61,63,316,3,0,319,148,467
4493,1,111,3,1,12,24,86,4,9,4,7,63,89,414,5,2,421,179,600
4494,0,157,0,1,1,25,90,6,2,0,17,65,66,430,2,0,432,168,600
4495,2,120,0,0,1,28,81,1,1,4,10,59,50,357,2,0,359,141,500
4496,1,118,2,0,2,16,63,6,6,3,12,58,53,340,3,0,343,157,500
4497,0,124,3,2,3,24,65,3,2,1,9,47,79,362,3,0,365,135,500
4498,0,121,0,0,5,19,78,3,3,0,13,53,61,356,3,2,361,163,524
4499,0,98,1,4,5,51,87,7,3,1,11,84,90,442,1,4,447,153,600
4500,4,130,1,2,3,37,66,1,2,2,12,70,90,420,4,0,424,176,600
4501,1,130,1,1,2,38,72,6,1,2,20,72,84,430,2,1,433,167,600
4502,1,112,1,0,4,33,103,10,5,4,14,86,85,458,5,1,464,136,600
4503,2,125,0,3,4,50,73,7,2,1,12,70,93,442,5,1,448,152,600
4504,3,141,2,0,3,42,101,1,7,3,5,54,71,433,3,2,438,162,600
4505,1,108,2,0,4,41,77,4,7,2,13,75,76,410,1,0,411,189,600
4506,1,138,2,1,4,45,77,11,2,2,6,74,63,426,5,0,431,169,600
4507,0,135,0,3,4,43,77,2,4,2,12,95,58,435,2,2,439,161,600
4508,2,122,1,0,0,33,61,1,3,2,8,63,77,373,1,0,374,126,500
4509,1,101,1,0,1,22,77,5,3,3,11,56,72,353,3,0,356,144,500
4510,1,102,0,0,2,30,81,7,4,1,12,61,72,373,1,0,374,126,500
4511,1,123,2,1,2,38,85,3,2,5,11,40,69,382,5,0,387,113,500
4512,2,138,2,2,2,47,87,2,3,1,21,38,79,424,4,0,428,116,544
4513,0,121,1,1,2,36,83,5,4,0,14,51,107,425,3,0,428,172,600
4514,1,107,1,0,1,28,63,5,4,4,7,56,82,359,4,1,364,136,500
4515,1,103,0,0,3,33,70,2,2,3,15,59,75,366,1,0,367,133,500
4516,0,139,3,1,4,29,56,2,3,3,6,51,84,381,1,0,382,118,500
4517,0,112,1,0,1,28,70,0,7,2,11,61,59,352,4,0,356,144,500
4518,0,100,1,1,2,34,74,3,2,3,12,36,93,361,0,0,361,148,509
4519,0,95,1,1,6,23,55,2,3,2,9,55,70,322,1,3,326,126,452
4520,0,77,1,1,1,27,71,5,2,0,9,48,73,315,2,1,318,132,450
4521,0,4,0,0,1,0,8,1,0,0,0,6,3,23,0,0,23,46,69
4522,0,0,0,0,1,4,15,1,0,1,1,0,8,31,1,0,32,64,96
4523,1,99,0,1,2,23,85,6,1,3,16,27,90,354,1,1,356,144,500
4524,0,100,3,0,4,28,74,3,3,2,14,38,85,354,4,1,359,141,500
4525,0,75,1,0,3,26,78,0,4,1,11,34,86,319,1,1,321,112,433
4526,0,85,0,0,7,21,59,0,3,0,7,28,35,245,4,1,250,100,350
4527,0,47,0,0,1,29,64,7,3,2,8,36,34,231,2,0,233,96,329
4528,2,108,0,1,2,30,54,3,2,3,10,48,77,340,4,0,344,156,500
4529,1,107,1,1,2,31,53,3,2,3,8,51,57,320,2,1,323,127,450
4530,0,101,2,1,0,34,50,3,6,2,8,57,69,333,2,0,335,115,450
4531,0,110,2,1,4,17,62,1,4,0,14,39,73,327,4,0,331,118,449
4532,0,150,1,1,9,33,86,7,4,4,15,38,93,441,6,0,447,153,600
4533,5,134,0,0,2,33,81,3,2,1,13,62,106,442,2,0,444,156,600
4534,1,122,0,1,4,30,80,10,0,3,14,53,118,436,3,1,440,160,600
4535,3,119,2,1,10,18,90,4,4,2,10,49,126,438,0,1,439,161,600
4536,2,125,1,0,3,26,96,4,3,3,11,45,112,431,2,0,433,167,600
4537,0,154,0,0,6,34,104,3,1,4,10,47,104,467,1,0,468,132,600
4538,0,141,0,0,7,44,73,4,3,2,14,58,71,417,5,0,422,178,600
4539,0,102,1,0,2,38,86,7,6,2,16,64,111,435,2,0,437,163,600
4540,0,151,0,0,2,32,99,5,8,1,9,53,95,455,3,0,458,142,600
4541,0,139,1,1,0,44,66,0,2,0,2,66,118,439,3,1,443,157,600
4542,0,116,0,1,1,20,65,1,5,1,11,42,107,370,2,1,373,127,500
4543,0,114,0,0,2,21,76,5,3,1,9,37,85,353,3,1,357,143,500
4544,0,112,0,0,4,30,53,3,4,1,11,38,78,334,2,0,336,164,500
4545,1,118,1,0,7,24,84,2,2,5,7,26,107,384,1,0,385,115,500
4546,1,109,0,0,6,38,113,5,2,2,11,29,104,420,2,0,422,125,547
4547,2,94,1,1,2,43,91,6,1,1,7,54,143,446,2,0,448,152,600
4548,0,117,2,0,6,25,93,5,2,1,19,62,110,442,5,1,448,152,600
4549,3,107,1,0,4,19,104,5,4,2,26,44,118,437,5,1,443,157,600
4550,0,111,1,1,2,36,91,3,4,3,7,52,135,446,6,0,452,148,600
4551,2,136,0,0,9,33,83,3,4,1,18,75,108,472,0,2,474,126,600
4552,3,115,0,1,1,37,93,7,2,0,15,72,106,452,1,2,455,145,600
4553,0,100,1,0,4,34,105,5,4,0,25,72,91,441,6,0,447,153,600
4554,0,117,2,1,0,32,112,3,1,2,16,55,118,459,0,0,459,141,600
4555,0,111,1,0,6,29,74,4,4,0,6,60,80,375,3,1,379,121,500
4556,1,104,1,0,4,33,70,8,3,1,3,44,83,355,3,1,359,141,500
4557,0,105,0,1,3,31,123,4,4,1,11,42,114,439,2,0,441,131,572
4558,0,114,0,1,3,22,99,7,4,0,7,39,154,450,0,1,451,149,600
4559,1,103,3,0,2,34,92,7,2,2,9,32,175,462,0,0,462,138,600
4560,0,113,0,0,0,20,102,2,3,2,2,27,193,464,3,1,468,132,600
4561,1,102,2,1,3,31,83,5,1,0,8,40,97,374,4,0,378,122,500
4562,1,80,1,1,2,24,95,4,8,0,3,39,124,382,2,0,384,116,500
4563,0,95,0,1,1,25,88,3,5,1,3,39,134,395,1,2,398,102,500
4564,1,111,0,0,3,26,115,5,2,0,8,20,135,426,2,0,428,98,526
4565,2,140,0,0,2,39,91,3,4,1,17,53,107,459,3,0,462,138,600
4566,0,121,1,0,2,37,98,2,2,2,20,45,147,477,4,0,481,119,600
4567,0,113,0,0,1,39,87,3,5,4,19,61,115,447,2,0,449,151,600
4568,1,152,0,0,1,38,80,5,3,3,19,56,106,464,3,0,467,133,600
4569,1,118,1,3,8,44,93,6,3,2,20,61,85,445,2,0,447,153,600
4570,1,139,0,1,5,35,77,5,2,4,14,62,112,457,1,0,458,142,600
4571,0,128,1,0,0,44,81,3,3,5,14,65,99,443,2,0,445,155,600
4572,1,114,0,0,3,51,87,3,6,4,12,69,82,432,2,0,434,166,600
4573,0,99,1,1,4,34,99,7,5,1,17,60,123,451,1,0,452,148,600
4574,1,131,0,1,3,28,97,3,4,1,25,62,125,481,4,0,485,115,600
4575,0,133,1,0,5,41,66,1,5,0,24,64,116,456,1,1,458,142,600
4576,1,109,1,1,3,19,71,3,6,1,20,58,81,374,1,0,375,125,500
4577,0,110,0,1,2,21,66,5,2,0,9,57,103,376,1,0,377,123,500
4578,1,119,0,0,0,33,68,5,1,0,18,38,104,387,2,0,389,111,500
4579,1,121,0,1,7,23,86,3,4,2,15,40,115,418,1,0,419,101,520
4580,0,132,0,0,1,43,131,3,6,2,23,54,97,492,3,0,495,105,600
4581,1,152,0,3,2,27,96,5,7,0,20,41,113,467,3,2,472,128,600
4582,0,121,2,0,3,37,93,3,4,0,12,33,87,395,0,1,396,104,500
4583,0,109,1,1,3,59,79,2,5,0,5,34,115,413,1,0,414,86,500
4584,2,126,0,0,2,29,103,0,7,0,14,38,73,394,0,0,394,113,507
4585,0,92,3,0,4,40,116,2,2,1,21,92,65,438,1,1,440,160,600
4586,0,130,2,1,3,40,57,4,4,0,24,81,89,435,0,0,435,165,600
4587,0,95,0,0,2,42,87,0,0,3,30,77,81,417,3,0,420,180,600
4588,2,101,0,2,2,45,98,3,5,2,19,68,97,444,4,0,448,152,600
4589,1,81,2,0,2,39,73,2,6,3,18,98,83,408,1,1,410,190,600
4590,2,120,5,1,0,36,88,5,4,1,17,101,55,435,2,5,442,158,600
4591,0,83,1,0,6,52,91,2,1,5,22,82,95,440,3,0,443,157,600
4592,2,101,1,0,5,43,69,5,5,2,29,97,69,428,2,0,430,170,600
4593,0,99,0,1,2,36,104,1,1,3,28,59,77,411,2,0,413,143,556
4594,0,123,4,0,3,21,82,1,6,3,13,93,106,455,2,0,457,143,600
4595,0,116,0,0,5,25,71,1,3,0,17,73,134,445,1,0,446,154,600
4596,0,105,2,0,3,44,73,7,1,1,17,75,119,447,2,0,449,151,600
4597,0,126,0,0,3,27,83,1,5,1,17,74,98,435,5,0,440,160,600
4598,0,128,0,1,3,32,63,2,5,2,14,87,103,440,6,0,446,154,600
4599,1,95,0,2,4,18,97,4,2,2,12,95,108,440,2,1,443,157,600
4600,0,120,1,0,2,26,78,5,8,1,10,77,99,427,2,3,432,168,600
4601,0,125,1,0,4,27,80,4,3,4,19,96,76,439,8,0,447,153,600
4602,2,124,0,1,0,33,86,7,3,2,17,81,83,439,1,2,442,158,600
4603,0,131,2,1,5,28,66,5,5,1,16,78,119,457,0,0,457,143,600
4604,1,133,3,0,2,42,79,3,5,2,17,66,82,435,2,0,437,163,600
4605,2,146,0,1,0,15,68,3,12,4,7,80,97,435,2,1,438,162,600
4606,1,119,1,3,1,31,85,2,2,1,10,93,92,441,2,0,443,157,600
4607,1,132,0,0,3,26,77,3,2,1,10,75,89,419,2,0,421,179,600
4608,1,117,0,1,1,24,88,4,3,3,9,80,102,433,0,0,433,167,600
4609,1,117,0,0,3,30,67,4,1,0,8,102,101,434,7,2,443,157,600
4610,1,144,1,1,2,25,71,3,7,1,13,67,94,430,4,1,435,165,600
4611,0,149,2,0,1,26,72,5,6,2,12,83,76,434,1,0,435,165,600
4612,1,146,0,0,2,20,73,5,0,0,12,91,109,459,4,0,463,137,600
4613,0,116,0,1,2,30,69,1,1,0,13,108,113,454,3,0,457,143,600
4614,0,165,2,0,3,34,72,4,2,4,10,71,93,460,2,1,463,137,600
4615,0,118,0,0,0,38,70,3,0,5,16,93,124,467,4,0,471,129,600
4616,2,135,1,0,6,29,69,2,3,4,12,79,111,453,4,0,457,143,600
4617,1,156,0,2,4,25,71,2,1,3,14,93,101,473,3,1,477,123,600
4618,1,143,1,0,7,28,69,2,0,1,10,63,120,445,2,1,448,152,600
4619,3,95,0,1,2,17,49,3,2,2,10,72,106,362,2,0,364,136,500
4620,0,132,0,0,3,21,70,6,1,2,6,47,90,378,3,0,381,119,500
4621,1,105,0,1,3,19,61,2,1,1,11,55,90,350,1,0,351,146,497
4622,1,93,4,0,2,26,38,5,5,1,23,101,61,360,1,0,361,139,500
4623,1,81,1,1,2,31,49,3,2,1,20,85,53,330,0,1,331,119,450
4624,1,85,2,1,2,22,40,2,2,4,8,96,62,327,3,0,330,120,450
4625,2,93,1,1,3,28,37,7,5,1,9,99,62,348,2,0,350,142,492
4626,2,153,0,1,8,44,74,3,2,2,10,51,100,450,0,0,450,150,600
4627,1,131,2,0,7,31,54,3,3,2,18,71,113,436,6,0,442,158,600
4628,1,135,2,2,3,25,87,2,5,1,23,63,111,460,4,1,465,135,600
4629,0,113,2,1,6,44,78,3,7,0,17,76,105,452,3,1,456,144,600
4630,1,116,1,0,3,28,67,0,3,0,12,70,80,381,3,0,384,116,500
4631,1,124,1,1,1,33,78,2,7,0,12,55,99,414,3,0,417,154,571
4632,0,4,1,0,1,2,15,0,1,1,4,4,11,44,1,0,45,45,90
4633,2,36,1,0,3,28,59,11,4,1,17,106,34,302,1,0,303,197,500
4634,0,61,2,0,1,31,54,4,2,2,15,98,22,292,1,2,295,205,500
4635,1,57,0,0,6,37,56,7,4,0,15,85,19,287,4,0,291,209,500
4636,1,40,0,0,2,46,51,7,5,1,13,102,43,311,0,1,312,188,500
4637,0,33,2,1,4,32,39,10,5,2,15,82,35,260,1,2,263,196,459
4638,0,2,0,0,0,0,3,1,1,0,0,5,1,13,1,0,14,25,39
4639,0,17,0,0,2,1,9,2,0,0,0,10,5,46,1,0,47,56,103
4640,2,36,1,0,3,25,35,8,1,2,15,112,21,261,0,0,261,239,500
4641,1,29,2,0,1,23,40,10,2,2,17,123,10,260,4,1,265,235,500
4642,2,28,2,1,3,22,46,8,1,2,10,118,10,253,5,2,260,240,500
4643,1,26,0,0,2,36,50,5,0,0,8,110,18,256,2,0,258,246,504
4644,0,16,1,0,0,22,27,5,2,2,6,119,21,221,6,1,228,129,357
4645,0,13,0,0,0,13,23,6,0,0,2,9,22,88,1,0,89,52,141
4646,1,20,1,0,4,21,28,6,0,0,4,70,13,168,3,1,172,178,350
4647,0,13,0,0,1,11,27,10,0,0,2,59,11,134,5,1,140,183,323
4648,1,35,0,0,2,16,71,12,2,0,6,118,11,274,5,1,280,265,545
4649,0,30,1,0,0,12,63,2,0,2,3,108,11,232,4,2,238,262,500
4650,1,21,0,0,1,16,48,7,2,1,12,101,19,229,3,1,233,284,517
4651,1,23,3,1,4,17,45,9,1,3,5,136,36,284,6,4,294,242,536
4652,1,28,2,0,1,25,53,2,0,4,21,119,25,281,3,0,284,216,500
4653,3,31,0,1,2,43,49,7,0,1,15,129,20,301,3,1,305,195,500
4654,1,48,0,0,3,27,51,3,2,0,13,117,41,306,2,3,311,219,530
4655,0,24,0,0,0,8,26,1,1,0,15,33,9,117,2,0,119,61,180
4656,0,19,1,0,4,20,54,6,0,0,5,78,19,206,2,1,209,202,411
4657,1,17,0,1,2,13,65,8,0,2,5,92,17,223,2,0,225,185,410
4658,1,77,1,0,1,29,37,3,1,1,19,124,44,338,4,0,342,258,600
4659,2,68,0,1,1,29,54,5,2,5,19,147,45,378,3,2,383,217,600
4660,2,54,1,2,1,36,47,5,3,1,15,162,42,371,2,0,373,227,600
4661,1,42,0,1,4,27,40,4,2,1,11,139,64,336,5,1,342,158,500
4662,1,46,0,0,1,30,43,0,1,2,10,145,29,308,2,0,310,190,500
4663,1,38,0,0,5,20,53,3,1,2,9,157,37,326,10,2,338,219,557
4664,1,17,1,0,0,20,16,2,0,0,6,22,41,126,4,4,134,86,220
4665,0,24,0,1,0,7,28,4,0,0,3,32,13,112,2,0,114,67,181
4666,0,49,0,0,3,31,77,5,1,1,8,85,48,308,16,2,326,158,484
4667,0,6,0,0,0,6,13,1,0,1,1,24,24,76,1,0,77,62,139
4668,2,25,4,0,3,28,47,5,2,3,7,203,22,351,4,0,355,262,617
4669,1,28,0,1,2,29,44,1,1,2,14,76,14,213,4,2,219,131,350
4670,1,21,1,0,0,20,31,7,1,1,12,81,20,196,4,0,200,134,334
4671,0,3,0,0,1,7,6,2,0,0,0,12,10,41,0,1,42,50,92
4672,0,2,0,0,1,0,12,1,0,0,0,10,3,29,1,1,31,26,57
4673,2,13,0,0,2,19,19,1,0,0,2,52,11,121,1,2,124,110,234
4674,0,1,0,0,0,1,7,0,0,0,1,0,4,14,0,0,14,12,26
4675,4,44,5,0,4,21,32,6,10,0,21,175,16,338,3,1,342,258,600
4676,1,32,1,0,1,30,39,1,2,1,19,139,15,281,8,0,289,211,500
4677,2,39,2,0,0,37,34,2,1,1,11,133,16,278,1,1,280,220,500
4678,2,37,2,2,1,35,46,3,0,2,15,127,15,287,11,2,300,200,500
4679,3,51,1,0,2,31,43,9,2,1,13,111,10,277,10,4,291,233,524
4680,4,45,4,1,2,25,31,3,5,0,15,207,21,363,7,0,370,230,600
4681,2,48,1,2,4,45,44,4,1,3,23,168,23,368,2,0,370,230,600
4682,2,45,3,0,3,48,39,4,7,0,16,174,21,362,9,1,372,228,600
4683,0,51,4,1,2,55,42,4,4,7,14,173,18,375,9,2,386,214,600
4684,2,59,2,0,1,31,44,1,7,1,20,163,16,347,6,0,353,197,550
4685,2,54,1,0,2,42,51,2,2,3,16,172,18,365,3,2,370,196,566
4686,0,19,1,0,3,32,26,4,2,2,7,133,22,251,7,1,259,176,435
4687,2,27,0,0,0,25,46,11,1,4,14,111,16,257,3,1,261,175,436
4688,1,27,0,2,1,50,71,3,0,1,9,150,19,334,3,1,338,206,544
4689,1,32,2,2,3,46,51,8,0,2,13,148,23,331,10,0,341,237,578
4690,3,36,2,3,1,63,68,3,2,3,15,137,17,353,8,4,365,212,577
4691,1,37,2,0,1,46,62,4,2,3,9,169,15,351,9,3,363,187,550
4692,3,59,2,0,2,45,62,3,4,4,32,129,25,370,7,0,377,210,587
4693,0,43,0,0,2,23,37,2,1,0,7,125,14,254,1,0,255,115,370
4694,1,6,0,2,0,10,2,1,0,0,0,36,2,60,1,0,61,36,97
4695,2,72,3,1,6,27,49,1,5,3,13,163,16,361,9,4,374,226,600
4696,0,72,2,3,6,27,51,4,8,4,13,153,17,360,3,2,365,235,600
4697,2,61,3,1,2,47,24,4,4,5,14,171,19,357,11,0,368,184,552
4698,1,54,0,0,1,45,39,1,1,4,17,168,16,347,6,1,354,196,550
4699,1,9,0,0,0,5,11,1,0,0,1,63,4,95,3,0,98,77,175
4700,2,46,0,1,1,50,59,7,4,4,18,174,30,396,11,1,408,170,578
4701,0,44,2,2,0,33,19,2,0,1,4,114,8,229,0,0,229,128,357
4702,3,34,0,0,3,17,27,4,2,2,6,108,37,243,8,3,254,121,375
4703,1,20,1,0,1,31,19,3,3,0,6,119,21,225,7,0,232,118,350
4704,1,18,0,0,2,11,28,3,1,1,4,103,12,184,0,1,185,95,280
4705,1,32,1,0,3,34,34,3,0,1,14,158,28,309,2,1,312,183,495
4706,1,46,0,0,7,41,71,4,0,1,16,129,8,324,6,2,332,139,471
4707,0,19,0,1,1,9,11,0,0,0,1,66,4,112,2,0,114,50,164
4708,1,22,0,3,0,22,11,5,0,1,12,76,10,163,1,6,170,92,262
4709,0,14,0,0,1,28,62,1,0,3,2,45,24,180,1,1,182,231,413
4710,1,12,0,0,0,4,26,1,0,0,3,5,19,71,0,0,71,97,168
4711,1,6,0,0,1,6,18,5,0,1,3,17,3,61,1,1,63,128,191
4712,1,79,1,1,1,51,89,5,2,0,16,68,72,386,3,2,391,209,600
4713,0,76,2,0,1,57,68,4,3,3,19,66,93,392,5,0,397,203,600
4714,2,77,1,2,4,42,72,1,3,5,20,70,78,377,2,1,380,220,600
4715,3,82,3,0,3,53,59,2,1,3,26,81,70,386,5,1,392,208,600
4716,2,105,1,4,4,48,85,0,2,6,16,69,54,396,2,0,398,202,600
4717,3,80,0,0,1,38,93,6,3,2,23,55,68,372,3,0,375,225,600
4718,1,62,0,0,2,36,86,2,2,1,21,67,38,318,5,1,324,176,500
4719,0,70,0,0,7,44,62,2,1,0,16,56,79,337,3,0,340,160,500
4720,0,61,0,1,3,30,62,1,3,2,18,67,77,325,0,1,326,174,500
4721,0,51,1,0,6,25,89,4,3,0,15,59,67,320,3,1,324,176,500
4722,3,61,0,1,6,31,68,2,2,2,16,60,58,310,3,1,314,186,500
4723,0,88,3,1,7,32,64,2,3,1,27,77,91,396,2,1,399,174,573
4724,1,34,0,0,0,29,44,1,3,2,10,42,26,192,2,0,194,184,378
4725,2,31,1,1,1,17,62,2,2,1,8,44,22,194,2,1,197,181,378
4726,0,8,1,0,1,2,62,0,1,6,7,36,23,147,4,4,155,270,425
4727,1,1,0,0,0,1,5,2,0,1,1,0,3,15,0,2,17,14,31
4728,2,55,0,1,2,29,44,1,2,1,8,51,48,244,4,0,248,202,450
4729,3,54,0,1,5,27,55,1,0,1,16,66,27,256,4,0,260,190,450
4730,3,46,1,1,2,22,55,1,3,1,8,63,32,238,2,1,241,158,399
4731,6,25,1,1,2,24,60,4,0,3,44,102,45,317,9,0,326,274,600
4732,1,28,1,0,1,29,67,5,1,4,19,94,48,298,6,4,308,292,600
4733,4,32,0,0,2,19,62,2,0,3,18,91,40,273,6,1,280,320,600
4734,1,47,0,0,2,14,74,3,4,1,23,88,41,298,3,1,302,298,600
4735,2,38,0,1,0,31,53,5,2,2,20,92,43,289,5,1,295,305,600
4736,3,37,0,1,1,28,62,3,1,2,24,93,42,297,8,2,307,293,600
4737,2,31,1,1,3,26,50,1,0,3,20,68,28,234,4,2,240,260,500
4738,0,33,0,0,4,19,53,2,1,1,17,93,22,245,14,0,259,241,500
4739,4,28,1,0,5,18,71,2,0,3,23,103,28,286,3,0,289,310,599
4740,1,75,3,2,0,56,70,3,2,1,18,79,51,361,2,0,363,237,600
4741,4,67,0,0,1,47,60,3,2,1,22,86,77,370,1,3,374,226,600
4742,4,74,1,0,2,45,81,2,2,2,23,69,53,358,4,0,362,238,600
4743,2,76,0,0,0,28,76,2,2,1,24,83,66,360,0,1,361,239,600
4744,2,90,1,2,3,42,60,1,4,7,26,75,53,366,3,0,369,231,600
4745,1,60,0,0,0,35,60,2,4,3,19,59,41,284,3,1,288,212,500
4746,1,67,1,3,2,40,51,2,1,4,21,80,44,317,2,0,319,231,550
4747,3,64,6,0,0,32,66,1,3,1,26,54,34,290,4,0,294,206,500
4748,1,57,1,0,2,22,68,4,5,1,18,86,47,312,2,2,316,181,497
4749,2,79,0,1,2,39,73,5,2,2,17,80,55,357,2,0,359,226,585
4750,2,55,3,0,2,34,63,5,1,3,19,121,23,331,1,1,333,267,600
4751,1,65,1,0,1,26,61,3,1,1,22,126,25,333,2,0,335,265,600
4752,0,40,1,1,4,29,41,3,3,4,15,108,43,292,2,4,298,302,600
4753,1,50,1,0,2,28,80,1,4,0,11,101,30,309,3,1,313,287,600
4754,1,49,1,0,2,27,53,1,3,2,17,131,23,310,4,3,317,283,600
4755,2,42,1,0,3,28,42,2,2,2,18,137,33,312,6,0,318,282,600
4756,1,44,1,0,4,37,63,3,1,1,28,90,44,317,2,1,320,280,600
4757,1,76,0,0,2,30,73,3,0,0,19,80,36,320,1,0,321,279,600
4758,2,42,1,1,1,37,53,3,1,5,15,96,38,295,6,1,302,298,600
4759,2,37,1,0,0,27,71,8,3,6,8,91,35,289,4,0,293,307,600
4760,4,43,0,0,1,33,64,2,0,2,15,119,28,311,3,1,315,285,600
4761,1,54,1,1,3,25,61,2,0,4,18,108,35,313,8,1,322,278,600
4762,2,49,1,2,2,31,41,4,1,1,17,114,36,301,4,3,308,292,600
4763,2,38,0,1,1,36,51,3,2,1,18,95,29,277,1,0,278,222,500
4764,2,37,3,0,0,19,56,1,5,3,9,100,32,267,6,1,274,226,500
4765,3,37,1,1,1,38,49,2,2,2,15,103,27,281,2,1,284,216,500
4766,3,38,2,0,1,32,37,3,3,4,19,86,40,268,4,1,273,227,500
4767,0,44,1,0,3,29,52,3,0,2,14,106,28,282,5,0,287,213,500
4768,2,49,0,4,1,30,69,1,2,3,17,91,35,304,5,2,311,274,585
4769,1,2,0,0,0,2,7,1,0,0,0,8,5,26,2,0,28,35,63
4770,1,30,2,0,2,2,39,4,0,1,8,26,22,137,1,0,138,80,218
4771,7,69,2,0,1,48,73,0,2,2,15,104,43,366,3,2,371,229,600
4772,5,80,5,2,4,39,61,3,2,4,23,111,42,381,5,2,388,212,600
4773,3,64,0,1,1,52,51,2,3,2,14,91,52,336,6,0,342,258,600
4774,3,72,0,1,3,51,71,5,1,4,19,99,51,380,7,0,387,213,600
4775,1,79,0,2,1,30,54,2,1,1,13,65,56,305,5,1,311,189,500
4776,4,48,0,1,4,49,65,2,2,4,20,94,54,347,1,1,349,201,550
4777,4,57,0,0,3,34,45,4,0,2,22,77,45,293,6,2,301,199,500
4778,3,61,2,0,6,36,65,2,1,1,21,93,39,330,1,0,331,169,500
4779,4,76,2,0,4,29,65,6,8,2,21,114,53,384,1,1,386,200,586
4781,1,86,0,1,6,41,54,3,4,3,18,76,75,368,7,0,375,225,600
4782,1,95,0,1,3,31,76,2,5,5,14,62,60,355,3,4,362,198,560
4783,1,78,0,0,2,38,48,1,2,4,15,74,65,328,5,0,333,217,550
4784,1,4,1,0,0,4,12,1,0,0,1,26,4,54,0,0,54,39,93
4785,0,54,0,0,1,41,76,1,3,0,28,93,68,365,11,0,376,242,618
4786,2,49,0,0,1,30,54,2,2,0,41,138,43,362,4,2,368,250,618
4787,2,23,2,1,2,25,83,2,0,1,6,90,16,253,4,1,258,224,482
4788,0,47,0,1,0,16,56,1,1,2,7,60,27,218,4,1,223,137,360
4789,0,0,0,0,0,5,20,1,2,1,0,34,4,67,3,0,70,45,115
4790,1,32,1,0,1,35,87,3,0,0,9,76,53,298,5,2,305,212,517
4791,2,18,2,1,1,21,80,2,1,5,9,75,41,258,3,1,262,254,516
4792,2,34,1,0,2,40,76,6,1,1,9,71,31,274,5,2,281,280,561
4793,1,40,0,0,0,47,95,3,3,3,13,50,47,302,3,1,306,244,550
4794,3,27,0,0,2,23,85,2,2,0,11,77,42,274,7,0,281,269,550
4795,2,28,0,0,0,6,69,1,2,2,10,96,16,232,3,3,238,134,372
4796,1,48,2,1,0,29,78,3,1,2,13,58,54,290,7,1,298,241,539
4797,1,31,0,0,3,24,82,3,0,0,17,79,34,274,2,1,277,223,500
4798,2,24,0,0,1,18,52,2,0,1,6,78,17,201,5,3,209,136,345
4799,0,110,0,2,2,40,83,1,2,2,17,63,102,424,2,2,428,172,600
4800,1,107,0,0,4,53,104,5,1,1,31,64,54,425,5,0,430,170,600
4801,0,80,1,0,3,35,114,0,3,1,26,84,81,428,0,2,430,170,600
4802,1,72,1,0,3,33,74,3,3,2,27,64,85,368,3,2,373,227,600
4803,0,76,2,1,2,38,85,5,8,0,29,89,68,403,5,0,408,192,600
4804,0,106,0,0,8,36,76,3,1,1,30,79,74,414,3,2,419,181,600
4805,0,104,3,0,5,42,93,8,2,0,23,69,70,419,6,0,425,175,600
4806,1,81,0,0,2,35,103,2,2,1,27,72,69,395,5,1,401,199,600
4807,0,76,1,3,3,55,63,5,3,0,28,86,66,389,2,1,392,208,600
4808,0,100,0,0,2,30,91,3,2,3,43,59,71,404,2,0,406,194,600
4809,1,77,2,1,3,43,81,1,1,2,27,90,68,397,9,1,407,193,600
4810,1,69,1,0,3,40,72,6,1,0,20,69,81,363,2,0,365,185,550
4811,0,66,1,2,2,51,74,3,3,0,9,73,64,348,3,0,351,199,550
4812,0,91,1,1,1,33,75,2,1,2,21,88,64,380,4,1,385,177,562
4813,0,35,0,0,3,24,48,2,1,1,24,46,45,229,7,2,238,139,377
4814,1,38,0,0,3,56,85,4,0,1,19,48,87,342,10,3,355,193,548
4815,0,15,0,0,3,8,38,5,1,0,7,68,42,187,9,2,198,195,393
4816,0,77,0,0,4,30,66,3,2,1,28,92,45,348,4,0,352,248,600
4817,2,49,3,0,5,34,91,4,0,3,23,95,52,361,5,1,367,233,600
4818,1,44,1,0,6,37,62,0,5,2,25,98,53,334,10,0,344,256,600
4819,0,45,2,0,6,36,81,2,1,2,26,77,51,329,5,1,335,265,600
4820,3,48,1,1,2,34,81,2,0,2,17,72,45,308,9,2,319,281,600
4821,0,38,0,0,2,41,66,3,2,5,26,88,49,320,5,0,325,275,600
4822,0,49,1,3,2,29,69,1,1,2,28,81,56,322,10,1,333,267,600
4823,0,42,1,0,1,35,59,5,0,0,25,64,67,299,4,2,305,245,550
4824,3,36,1,0,5,37,59,5,1,1,17,110,56,331,7,0,338,248,586
4825,1,23,1,0,2,31,63,2,1,4,8,41,76,253,6,0,259,156,415
4826,0,17,1,0,0,24,72,3,0,2,6,121,48,294,8,1,303,147,450
4827,0,26,0,0,0,30,43,1,0,1,9,89,62,261,7,2,270,153,423
4828,1,14,2,1,1,11,60,5,1,1,9,84,53,243,4,0,247,140,387
4829,0,7,0,1,1,17,64,3,0,0,10,87,33,223,5,1,229,121,350
4830,0,6,1,0,0,12,15,0,0,1,0,4,35,74,0,1,75,45,120
4831,0,13,0,0,2,17,54,1,1,2,3,24,33,150,2,0,152,77,229
4832,1,14,4,1,0,15,86,2,0,1,14,70,93,301,6,2,309,127,436
4833,2,10,0,0,2,3,17,0,0,0,6,42,29,111,3,2,116,56,172
4834,2,55,1,0,2,54,47,3,1,1,12,83,35,296,8,4,308,158,466
4835,2,56,0,0,0,36,55,3,1,2,8,82,27,272,6,2,280,170,450
4836,1,42,1,0,1,42,73,2,1,1,9,57,46,276,6,1,283,145,428
4837,1,32,0,0,4,32,104,1,2,3,8,40,49,276,4,0,280,148,428
4838,0,3,0,0,0,1,10,1,0,0,0,7,6,28,1,0,29,21,50
4839,0,18,0,0,1,28,67,5,0,0,3,73,48,243,8,0,251,126,377
4840,0,62,1,1,3,42,101,5,0,4,15,69,47,350,5,0,355,246,601
4841,0,14,0,1,0,3,14,0,2,2,4,5,11,56,1,0,57,40,97
4842,0,1,0,1,0,1,9,0,0,0,1,1,7,21,0,0,21,8,29
4843,0,31,0,0,0,29,70,2,1,0,4,33,26,196,7,2,205,167,372
4844,0,17,1,0,2,13,37,1,0,0,18,67,22,178,1,2,181,156,337
4845,0,16,0,0,1,21,38,1,0,0,12,62,20,171,14,2,187,150,337
4846,1,38,0,1,6,32,87,1,1,2,16,67,62,314,5,1,320,151,471
4847,1,30,0,1,5,31,82,6,0,2,22,62,54,296,3,0,299,161,460
4848,0,36,0,0,2,24,114,2,0,1,22,40,49,290,3,2,295,165,460
4849,0,2,0,0,0,9,14,0,0,0,0,7,20,52,0,0,52,14,66
4850,0,34,0,0,0,29,52,1,1,1,18,118,34,288,3,3,294,153,447
4851,1,37,1,1,2,57,47,2,3,3,11,81,72,318,2,2,322,140,462
4852,0,21,1,0,2,7,62,2,0,2,3,39,12,151,5,2,158,141,299
4853,1,37,2,0,2,22,82,1,1,1,9,56,53,267,1,0,268,120,388
4854,1,5,0,0,2,19,35,1,1,0,5,29,25,123,3,0,126,64,190
4855,0,22,1,0,0,15,47,1,0,2,10,41,23,162,3,2,167,109,276
4856,1,17,3,1,2,9,43,0,2,0,13,62,66,219,6,0,225,152,377
4857,1,14,0,1,0,22,55,0,1,0,8,59,57,218,3,2,223,127,350
4858,0,27,0,0,9,18,71,1,1,1,22,85,43,278,6,0,284,153,437
4859,0,12,0,1,8,20,79,4,3,1,12,61,37,238,13,0,251,149,400
4860,0,5,0,0,5,10,33,0,2,0,8,10,52,125,1,0,126,34,160
4861,1,31,0,0,0,13,138,1,4,1,10,36,12,247,5,1,253,97,350
4862,0,35,0,0,1,24,76,4,0,2,33,61,69,305,9,1,315,206,521
4863,0,24,1,0,2,12,45,2,1,3,7,29,47,173,2,2,177,100,277
4864,0,26,0,0,20,17,94,0,0,2,14,39,90,302,5,5,312,169,481
4865,1,6,0,0,0,20,26,0,0,0,1,24,22,100,2,1,103,43,146
4866,1,14,0,0,3,10,80,0,0,0,7,39,80,234,7,3,244,108,352
4867,1,37,2,4,7,22,119,1,1,1,7,120,94,416,10,2,428,198,626
4868,1,19,23,0,1,14,56,0,1,1,4,24,0,144,8,0,152,97,249
4869,0,0,0,0,1,3,47,0,0,1,2,5,9,68,0,0,68,47,115
4870,0,12,1,1,1,40,71,2,0,0,28,23,58,237,6,1,244,101,345
4871,0,4,0,1,2,20,43,0,0,1,0,18,16,105,2,0,107,61,168
4872,0,4,0,0,0,5,17,2,0,0,1,17,6,52,1,0,53,38,91
4873,0,12,0,0,8,12,71,0,0,2,4,30,48,187,1,1,189,102,291
4874,0,23,0,0,3,68,104,3,1,0,12,116,82,412,5,2,419,225,644
4875,0,33,0,0,0,15,67,1,3,1,15,35,95,265,2,0,267,102,369
4876,1,13,0,1,0,4,59,0,0,0,8,9,7,102,1,3,106,27,133
4877,0,27,0,0,0,5,27,3,1,5,10,48,40,166,3,0,169,113,282
4878,1,25,1,0,5,23,38,2,0,2,13,129,80,319,4,0,323,110,433
4879,0,11,0,0,1,27,53,4,1,1,11,43,36,188,4,3,195,137,332
4880,2,6,2,0,1,19,54,3,0,1,8,28,96,220,9,3,232,87,319
4881,0,29,0,2,7,65,30,4,1,3,16,36,23,216,8,4,228,205,433
4882,0,30,0,1,7,56,51,6,1,3,7,62,15,239,8,2,249,184,433
4883,2,25,0,0,6,73,37,2,0,2,6,47,15,215,6,3,224,210,434
4884,1,22,0,0,0,16,45,3,2,1,25,64,44,223,5,2,230,153,383
4885,0,2,1,0,0,2,3,1,1,1,2,11,14,38,6,0,44,48,92
4886,0,8,0,0,2,6,37,0,0,0,2,8,2,65,0,0,65,56,121
4887,1,38,2,0,1,31,101,4,6,3,9,95,26,317,4,2,323,227,550
4888,1,23,1,0,7,23,86,4,2,2,8,80,29,266,9,1,276,224,500
4889,2,25,0,1,2,24,120,2,5,1,12,69,22,285,9,2,296,204,500
4890,1,30,1,0,1,19,110,2,2,1,12,85,13,277,3,2,282,218,500
4891,0,19,0,1,1,21,50,1,3,1,10,84,20,211,6,1,218,235,453
4892,1,1,0,0,0,0,13,3,0,0,0,10,2,30,0,0,30,26,56
4893,0,18,0,0,0,11,41,5,0,1,10,37,27,150,1,1,152,88,240
4894,0,29,1,0,2,12,81,1,3,1,4,80,33,247,3,0,250,187,437
4895,1,5,0,0,0,4,57,1,0,2,15,19,12,116,1,2,119,50,169
4896,0,12,1,1,0,16,37,0,0,1,4,12,35,119,4,2,125,55,180
4897,1,13,0,1,3,29,35,6,0,0,9,28,14,139,6,1,146,108,254
4898,0,14,0,0,1,12,93,1,2,1,5,13,16,158,0,1,159,96,255
4899,3,14,1,1,0,1,52,1,0,2,12,17,36,140,3,0,143,50,193
4900,1,28,0,0,0,24,68,4,0,0,4,58,105,292,1,3,296,141,437
4901,0,28,0,0,0,22,86,6,0,0,11,18,84,255,3,1,259,141,400
4902,1,18,0,0,0,20,57,1,0,0,8,15,11,131,4,3,138,57,195
4903,0,4,1,0,0,2,14,0,0,0,2,1,9,33,2,0,35,30,65
4904,0,5,0,0,0,4,19,0,1,0,1,7,16,53,1,2,56,14,70
4905,3,70,2,1,2,37,68,0,1,0,19,68,73,344,4,0,348,252,600
4906,2,66,0,2,3,47,96,4,2,2,22,67,73,386,7,2,395,205,600
4907,2,59,2,0,0,79,78,2,4,3,17,52,66,364,3,0,367,233,600
4908,2,82,0,1,1,59,64,1,0,2,27,73,62,374,3,2,379,221,600
4909,1,56,0,0,0,63,78,3,2,0,23,77,73,376,7,2,385,215,600
4910,1,40,2,0,0,53,63,1,2,2,29,72,58,323,5,0,328,272,600
4911,0,63,0,0,1,68,89,1,4,0,22,66,63,377,3,1,381,219,600
4912,0,58,0,1,4,38,78,1,1,1,20,63,84,349,3,5,357,243,600
4913,2,76,1,0,2,46,83,4,0,1,15,58,83,371,7,1,379,221,600
4914,0,57,2,0,2,50,75,3,2,0,30,76,79,376,0,0,376,224,600
4915,0,73,0,2,0,48,93,1,0,2,17,68,65,369,6,3,378,222,600
4916,1,38,0,2,2,51,88,0,3,2,18,75,61,341,3,2,346,254,600
4917,4,52,3,0,2,54,77,2,0,1,27,64,63,349,1,1,351,249,600
4918,1,49,0,0,0,45,75,2,2,4,16,48,61,303,4,0,307,243,550
4919,2,59,0,2,1,49,74,1,2,0,16,65,77,348,3,4,355,195,550
4920,4,63,1,1,2,49,72,3,0,1,14,68,61,339,6,0,345,205,550
4921,1,57,1,0,1,46,75,3,0,3,24,57,64,332,3,0,335,215,550
4922,0,51,0,1,1,48,90,4,3,0,14,61,59,332,4,0,336,214,550
4923,3,60,1,2,2,44,51,3,1,2,26,55,53,303,2,0,305,245,550
4924,0,54,1,1,0,48,71,3,3,1,29,59,49,319,10,0,329,224,553
4925,1,41,0,1,2,37,84,0,1,1,9,46,44,267,5,1,273,177,450
4926,1,42,1,1,2,51,80,3,1,0,8,37,45,272,4,0,276,174,450
4927,1,43,0,1,1,36,75,2,1,0,12,41,48,261,3,1,265,159,424
4928,1,48,1,1,1,42,63,2,2,0,18,38,34,251,10,5,266,225,491
4929,1,56,1,2,0,47,57,2,1,1,20,47,51,286,6,2,294,196,490
4930,0,35,1,1,0,24,54,4,0,2,16,47,52,236,5,0,241,124,365
4931,0,34,0,0,2,23,62,1,2,1,14,50,33,222,6,2,230,134,364
4932,0,43,3,2,3,48,86,2,0,3,17,88,56,351,10,0,361,219,580
4933,3,20,0,0,1,30,38,1,1,0,9,35,21,159,1,3,163,163,326
4934,1,26,0,2,2,36,28,2,0,0,14,25,23,159,1,0,160,165,325
4935,0,2,0,0,0,3,4,0,0,1,1,11,0,22,1,0,23,22,45
4936,2,34,3,0,2,34,49,1,0,5,17,29,17,193,3,1,197,134,331
4937,1,33,1,0,3,39,48,1,1,1,9,33,36,206,3,1,210,121,331
4938,0,25,0,1,1,61,83,6,0,2,18,37,35,269,3,1,273,172,445
4939,0,0,0,0,0,1,2,0,0,1,0,0,1,5,0,2,7,8,15
4940,1,34,0,1,1,53,55,4,0,0,9,55,71,284,8,2,294,219,513
4941,1,25,1,1,1,49,59,0,1,1,9,57,27,232,3,3,238,157,395
4942,0,21,1,0,1,51,104,3,5,4,13,57,36,296,8,2,306,182,488
4943,0,18,2,1,0,33,67,3,5,2,14,62,40,247,15,0,262,225,487
4944,0,25,0,0,0,71,74,5,1,0,6,95,37,314,9,1,324,227,551
4945,1,20,0,0,0,52,59,2,0,0,19,89,39,281,10,1,292,259,551
4946,2,22,0,0,1,75,54,3,0,0,21,42,36,256,5,2,263,237,500
4947,0,23,1,0,2,79,79,0,0,1,10,23,34,252,6,0,258,242,500
4948,2,28,0,0,0,78,62,2,2,2,12,38,34,260,4,6,270,253,523
4949,1,25,2,1,1,20,34,4,0,0,7,62,67,224,15,4,243,184,427
4950,3,19,1,0,1,52,73,1,1,3,5,41,16,216,3,0,219,168,387
4951,0,12,2,0,2,43,40,1,0,1,6,79,23,209,5,0,214,136,350
4952,2,14,0,0,1,28,56,0,0,1,9,62,16,189,4,1,194,149,343
4953,2,12,0,1,1,26,69,3,0,1,18,37,43,213,10,5,228,154,382
4954,0,5,0,1,1,5,55,0,0,5,4,3,27,106,5,3,114,83,197
4955,1,2,0,0,0,9,8,1,1,0,5,14,10,51,0,2,53,39,92
4956,0,22,0,0,0,47,75,5,2,5,13,33,39,241,9,1,251,175,426
4957,0,16,0,1,2,28,114,4,1,1,4,33,33,237,4,5,246,276,522
4958,1,18,0,0,1,19,52,1,0,1,7,70,40,210,3,1,214,179,393
4959,1,18,0,0,0,31,59,2,0,1,10,38,48,208,2,0,210,183,393
4960,3,22,1,1,2,20,32,5,0,0,12,67,27,192,2,3,197,203,400
4961,0,33,1,0,1,22,34,3,0,2,9,78,18,201,3,0,204,226,430
4962,4,58,2,0,6,41,43,2,0,2,15,37,34,244,14,1,259,233,492
4963,0,22,1,2,0,24,42,3,1,1,5,48,53,202,1,2,205,160,365
4964,0,35,0,0,0,46,26,1,0,0,8,51,38,205,6,0,211,153,364
4965,2,47,1,3,6,72,87,3,1,2,32,43,33,332,9,4,345,255,600
4966,2,56,0,1,3,54,84,4,1,0,31,55,33,324,10,1,335,215,550
4967,2,37,1,1,4,70,56,2,0,3,23,68,24,291,9,4,304,196,500
4968,1,46,0,0,5,80,59,1,1,1,14,66,18,292,3,2,297,203,500
4969,1,46,2,0,6,76,54,3,4,1,39,43,23,298,5,0,303,222,525
4970,1,52,0,1,9,22,40,3,1,4,16,31,14,194,2,0,196,108,304
4971,4,19,0,0,1,37,49,1,0,2,23,56,38,230,12,8,250,159,409
4972,0,14,1,0,0,11,35,3,0,1,4,56,22,147,1,1,149,95,244
4973,3,15,1,1,8,11,16,1,0,2,6,109,20,193,6,4,203,199,402
4974,0,2,0,0,0,11,69,0,0,3,1,6,10,102,1,1,104,46,150
4975,0,1,0,0,0,10,4,0,0,0,1,7,5,28,0,0,28,19,47
4976,0,3,0,0,0,1,12,2,0,0,0,4,9,31,1,0,32,15,47
4977,3,57,0,1,2,40,81,1,0,0,19,40,69,313,5,3,321,179,500
4978,0,47,1,0,1,49,55,1,0,3,21,53,80,311,5,3,319,181,500
4979,2,63,1,1,2,44,44,1,3,1,23,44,73,302,10,2,314,186,500
4980,2,41,0,0,0,42,53,0,0,0,27,43,69,277,3,3,283,212,495
4981,0,29,1,0,1,21,57,1,1,1,6,15,60,193,5,1,199,165,364
4982,1,20,0,0,1,10,48,1,0,1,18,27,19,146,7,2,155,192,347
4983,3,29,0,0,2,39,71,1,2,0,9,56,66,278,7,2,287,194,481
4984,0,43,1,0,5,30,59,6,1,0,10,54,25,234,8,3,245,185,430
4985,0,40,1,1,2,31,77,2,1,2,15,63,28,263,3,4,270,159,429
4986,0,47,0,0,2,22,65,7,0,0,11,42,29,225,8,1,234,195,429
4987,1,21,1,0,1,30,61,2,1,1,3,45,15,182,3,2,187,207,394
4988,1,27,1,0,0,27,62,3,1,1,8,34,18,183,1,2,186,208,394
4989,0,39,1,1,2,60,69,4,1,6,13,61,47,304,5,4,313,287,600
4990,3,43,1,1,1,44,56,3,0,2,14,69,52,289,5,0,294,306,600
4991,0,49,4,1,1,43,83,4,2,2,16,58,51,314,8,0,322,278,600
4992,3,48,0,1,4,41,97,7,1,0,10,46,43,301,7,2,310,239,549
4993,2,40,1,0,1,32,58,6,1,1,6,41,40,229,6,1,236,164,400
4994,2,34,0,2,0,55,48,4,1,0,8,30,39,223,8,2,233,126,359
4995,0,24,1,0,1,46,78,6,1,1,9,30,42,239,8,5,252,236,488
4996,0,26,1,0,1,25,62,1,0,0,9,100,46,271,10,4,285,128,413
4997,1,48,2,0,2,31,56,4,2,3,8,105,63,325,2,0,327,273,600
4998,2,50,1,0,1,38,51,2,2,0,23,68,47,285,3,1,289,261,550
4999,1,35,0,1,2,25,53,2,0,1,10,69,53,252,4,1,257,293,550
5000,0,41,0,0,5,31,75,1,1,1,13,59,56,283,8,0,291,259,550
5001,0,47,0,0,5,30,66,5,1,1,10,71,45,281,3,1,285,265,550
5002,3,52,2,0,6,30,39,3,2,2,8,93,51,291,3,1,295,255,550
5003,0,41,0,0,3,24,62,3,3,2,19,96,44,297,2,0,299,251,550
5004,0,49,0,0,1,21,78,4,7,4,13,89,68,334,3,1,338,212,550
5005,1,60,0,0,3,34,53,3,2,3,11,75,55,300,3,0,303,265,568
5006,0,12,0,0,0,7,44,1,1,1,4,28,22,120,1,0,121,103,224
5007,0,7,0,1,1,4,35,2,0,1,5,37,9,102,1,0,103,63,166
5008,0,11,0,1,1,10,18,0,0,0,1,12,21,75,0,0,75,51,126
5009,0,20,2,0,0,18,25,2,2,3,7,80,13,172,2,0,174,156,330
5010,2,29,1,1,0,20,23,1,5,1,22,60,15,180,2,1,183,148,331
5011,1,26,1,1,1,34,58,1,1,2,5,78,29,238,7,0,245,305,550
5012,3,22,1,1,2,39,74,2,0,2,10,100,27,283,1,0,284,269,553
5013,0,13,0,1,0,18,27,1,0,0,3,40,14,117,4,0,121,101,222
5014,1,8,0,0,0,10,41,1,0,1,8,33,19,122,2,0,124,119,243
5015,1,18,0,0,3,24,32,8,0,2,12,22,13,135,1,1,137,147,284
5016,0,16,0,1,1,5,9,0,0,0,0,8,16,56,0,0,56,11,67
5017,1,80,0,0,5,31,65,1,1,4,12,142,45,387,2,1,390,190,580
5018,1,76,0,0,7,34,60,1,0,1,11,131,41,363,6,2,371,208,579
5019,1,93,0,1,9,38,62,0,2,1,7,89,35,338,5,0,343,236,579
5020,0,43,0,0,3,13,44,2,0,1,8,84,25,223,2,1,226,164,390
5021,1,100,1,0,3,35,43,0,2,2,9,155,48,399,9,2,410,190,600
5022,0,123,1,2,3,49,32,0,5,1,9,128,38,391,6,0,397,203,600
5023,0,105,4,1,1,34,47,2,0,3,17,131,47,392,3,1,396,204,600
5024,1,104,1,4,5,37,39,1,3,2,16,132,44,389,6,2,397,174,571
5025,1,16,0,0,3,6,28,3,0,0,9,23,21,110,1,0,111,80,191
5026,0,5,0,0,0,9,20,3,0,1,4,7,5,54,1,0,55,55,110
5027,1,26,0,1,4,29,71,0,4,1,7,191,47,382,5,3,390,204,594
5028,1,25,0,0,3,17,37,0,1,0,2,34,5,125,3,1,129,49,178
5029,1,43,0,0,2,44,81,3,3,1,31,48,59,316,7,1,324,226,550
5030,1,38,0,1,5,37,88,0,3,1,34,58,50,316,3,1,320,230,550
5031,1,50,1,1,4,34,75,2,3,0,26,58,60,315,2,0,317,233,550
5032,1,44,0,0,4,31,72,1,2,0,41,43,62,301,6,3,310,240,550
5033,4,47,2,0,1,24,56,1,4,0,23,55,55,272,9,1,282,268,550
5034,2,33,1,1,1,34,70,2,3,1,35,39,74,296,3,3,302,248,550
5035,4,37,0,3,3,34,82,0,3,3,27,49,72,317,7,1,325,225,550
5036,1,39,0,2,1,30,78,0,2,2,24,69,68,316,5,4,325,225,550
5037,1,38,1,1,2,19,88,0,4,3,21,61,43,282,5,1,288,253,541
5038,1,8,1,0,1,5,31,2,1,1,8,52,18,129,11,1,141,75,216
5039,0,9,0,0,0,19,104,1,1,1,17,165,11,328,11,0,339,294,633
5040,1,44,2,1,2,42,78,1,2,0,31,103,49,356,6,2,364,240,604
5041,0,41,4,0,4,40,59,4,1,2,17,87,48,307,5,1,313,292,605
5042,2,26,2,1,1,42,65,4,1,2,9,65,38,258,12,2,272,278,550
5043,2,40,0,1,0,40,87,7,2,0,18,68,42,307,7,2,316,255,571
5044,2,42,1,0,0,31,120,1,0,0,17,39,46,299,6,1,306,194,500
5045,2,42,4,0,2,23,120,3,1,1,21,34,44,297,5,3,305,204,509
5046,0,54,0,0,0,31,103,6,1,2,25,69,46,337,6,0,343,257,600
5047,1,40,1,0,4,37,79,0,1,2,12,92,47,316,9,1,326,274,600
5048,0,45,0,0,1,29,91,3,1,2,11,95,48,326,10,0,336,264,600
5049,1,43,0,0,2,46,68,2,2,1,14,77,43,299,8,2,309,241,550
5050,1,33,0,1,1,35,86,6,5,2,15,92,41,318,3,2,323,227,550
5051,1,53,0,0,1,37,82,4,0,2,18,85,56,339,5,1,345,233,578
5052,0,19,1,1,1,26,68,0,1,1,15,56,36,225,3,1,229,211,440
5053,1,23,1,0,0,37,58,2,2,1,12,75,31,243,4,1,248,193,441
5054,4,23,3,1,0,13,114,2,1,3,7,134,38,343,10,1,354,204,558
5055,2,47,1,0,3,24,57,10,0,3,7,85,41,280,1,3,284,316,600
5056,2,38,0,1,1,31,51,11,2,2,13,142,23,317,6,1,324,276,600
5057,2,42,3,0,1,24,49,7,1,0,4,92,43,268,0,1,269,281,550
5058,0,39,2,1,1,33,63,10,1,1,13,91,36,291,4,0,295,255,550
5059,1,44,1,0,2,27,42,13,3,1,10,104,27,275,1,0,276,282,558
5060,0,25,2,0,2,31,64,5,2,0,7,46,38,222,1,1,224,221,445
5061,0,14,0,1,0,17,13,0,0,1,2,27,7,82,8,2,92,78,170
5062,1,18,4,0,2,23,32,1,3,3,12,41,19,159,3,0,162,227,389
5063,1,22,1,0,0,22,52,4,0,2,7,45,45,201,8,0,209,213,422
5064,1,4,0,1,0,0,3,0,0,0,1,2,2,14,1,0,15,15,30
5065,1,46,3,2,1,41,72,1,2,2,6,111,51,339,8,3,350,247,597
5066,1,24,0,0,0,27,78,2,1,2,10,104,67,316,6,0,322,275,597
5067,0,45,0,0,0,32,61,2,2,3,13,102,37,297,17,1,315,282,597
5068,0,43,1,0,4,27,78,5,0,1,12,98,41,310,14,4,328,269,597
5069,1,33,0,1,0,45,67,4,2,2,15,90,34,294,8,1,303,294,597
5070,1,32,1,0,1,30,101,2,2,1,8,69,53,301,6,1,308,257,565
5071,1,31,0,1,0,15,109,4,1,1,3,77,43,286,12,4,302,262,564
5072,1,16,2,1,3,14,34,1,1,3,10,82,77,245,7,4,256,139,395
5073,0,10,0,0,1,13,67,5,1,1,3,18,92,211,5,4,220,106,326
5074,0,29,1,1,0,28,64,2,2,3,7,202,35,374,18,3,395,138,533
5075,1,6,0,0,0,28,33,2,0,1,6,30,17,124,2,1,127,111,238
5076,2,9,3,0,1,13,34,1,1,2,12,50,49,177,7,1,185,132,317
5077,1,76,0,1,1,29,78,3,1,4,10,85,45,334,7,1,342,258,600
5078,0,43,1,2,3,37,66,0,0,3,7,102,35,299,5,0,304,296,600
5079,0,43,1,1,2,42,67,2,0,3,18,93,65,337,6,1,344,256,600
5080,0,60,0,0,0,52,44,3,1,4,10,97,49,320,3,0,323,277,600
5082,2,66,1,0,4,47,72,4,3,1,14,82,35,331,2,1,334,266,600
5083,0,54,1,0,5,40,73,2,4,2,22,93,47,343,5,1,349,251,600
5084,3,65,3,2,3,34,63,1,5,5,8,106,49,347,6,0,353,247,600
5085,0,42,2,0,2,42,88,0,1,2,17,102,33,331,3,2,336,264,600
5086,1,56,1,0,2,38,54,0,1,2,23,109,48,335,6,0,341,259,600
5087,2,83,0,0,2,36,72,0,1,0,7,106,49,358,2,0,360,240,600
5088,3,59,1,1,1,35,76,2,1,1,12,93,54,339,6,1,346,260,606
5089,1,13,0,1,1,13,77,1,0,0,1,112,17,237,13,2,252,226,478
5090,2,27,1,1,1,38,72,2,1,0,20,68,26,259,9,1,269,205,474
5101,2,61,1,0,2,34,59,5,3,1,12,112,35,327,4,0,331,232,563
5102,0,57,0,0,4,35,56,0,0,1,15,124,44,336,0,1,337,223,560
5103,0,0,0,1,2,4,6,0,0,0,2,3,3,21,1,0,22,3,25
5104,0,5,0,0,0,12,28,3,2,2,7,114,28,201,4,1,206,294,500
5105,1,7,1,0,3,12,28,1,0,1,5,133,27,219,5,0,224,276,500
5106,0,5,0,0,1,10,44,2,0,0,2,114,21,199,2,0,201,306,507
5107,1,20,0,0,0,7,19,2,1,5,6,120,26,207,5,0,212,113,325
5108,1,37,0,2,1,28,79,2,2,0,10,38,37,237,2,5,244,131,375
5109,1,10,1,0,1,10,18,3,0,2,1,6,9,62,1,0,63,49,112
5110,0,18,0,0,1,28,58,3,2,1,9,76,25,221,2,1,224,156,380
5111,1,18,0,0,3,22,72,0,1,0,19,75,19,230,8,2,240,145,385
5112,0,25,0,0,1,7,49,1,1,0,9,52,20,165,7,0,172,151,323
5113,0,8,1,0,0,20,11,1,0,0,0,1,11,53,1,0,54,45,99
5114,2,9,1,1,2,18,57,2,1,0,7,100,10,210,8,2,220,205,425
5115,0,15,0,1,1,21,55,1,0,0,8,122,10,234,3,1,238,186,424
5116,0,18,1,0,2,10,59,2,2,0,8,96,11,209,5,0,214,186,400
5117,1,24,2,0,2,24,86,3,0,2,2,37,24,207,7,2,216,137,353
5118,0,7,1,0,3,6,36,0,0,1,3,20,12,89,0,0,89,51,140
5119,0,56,0,0,2,36,79,3,0,4,16,72,60,328,4,1,333,217,550
5120,0,68,5,2,3,41,96,3,1,2,18,60,50,349,7,1,357,193,550
4780,1,10,0,1,2,5,46,2,1,3,2,32,11,116,4,0,120,157,277
5081,0,70,0,0,2,57,73,0,3,3,10,92,47,357,3,2,362,239,601
5091,0,6,0,0,0,7,10,1,1,0,2,17,11,55,0,0,55,60,115
5092,0,20,0,1,0,23,60,2,0,0,10,49,36,201,5,0,206,163,369
5093,0,52,1,0,4,33,58,1,0,4,16,123,42,334,4,1,339,208,547
5094,1,51,2,2,4,31,66,1,1,2,18,115,33,327,9,0,336,211,547
5095,1,43,0,0,2,42,57,4,1,3,7,95,37,292,5,1,298,249,547
5096,1,57,1,0,1,29,56,2,3,5,14,109,26,304,4,0,308,237,545
5097,0,54,3,0,1,45,45,5,1,1,13,133,38,339,0,0,339,224,563
5098,2,60,0,0,3,38,55,6,0,2,15,139,34,354,5,0,359,204,563
5099,3,56,0,0,1,41,64,1,1,3,8,102,41,321,1,2,324,239,563
5100,0,57,0,0,1,33,65,6,2,3,16,102,38,323,2,0,325,238,563
5121,0,55,3,1,3,46,66,5,1,5,15,69,48,317,2,3,322,228,550
5122,0,61,2,0,1,46,99,0,1,4,14,67,54,349,5,0,354,196,550
5123,0,40,3,0,1,53,65,4,0,0,24,76,52,318,3,0,321,229,550
5124,1,71,7,1,2,33,79,4,2,2,9,69,54,334,3,1,338,212,550
5125,0,59,3,0,3,51,91,3,2,4,19,65,45,345,3,1,349,201,550
5126,0,67,4,0,0,46,69,2,1,2,18,73,54,336,6,0,342,208,550
5127,0,57,6,0,4,62,65,6,1,3,24,63,53,344,3,0,347,217,564
5128,6,0,1,0,0,12,25,1,0,0,6,4,8,63,3,0,66,70,136
5129,0,18,2,0,5,10,75,3,2,1,9,54,33,212,5,1,218,182,400
5130,2,15,0,0,1,17,67,1,0,0,7,63,25,198,3,0,201,207,408
5131,1,29,0,1,4,39,48,4,1,3,20,126,31,307,12,0,319,231,550
5132,1,35,2,0,5,32,35,6,0,4,12,119,40,291,7,3,301,257,558
5133,1,9,0,0,0,19,21,1,0,1,6,13,11,82,2,0,84,78,162
5134,0,3,0,1,0,5,1,0,0,0,4,3,12,29,0,0,29,27,56
5135,0,2,0,0,0,0,6,0,0,0,0,0,8,16,0,0,16,18,34
5136,1,14,2,0,6,43,64,7,0,2,7,22,11,179,4,1,184,129,313
5137,1,24,0,0,0,5,7,5,0,0,2,5,9,58,0,0,58,41,99
5138,1,19,1,1,0,9,19,4,0,0,13,40,26,133,3,0,136,73,209
5139,2,11,1,0,0,7,45,1,0,0,5,18,26,116,1,0,117,92,209
5140,0,46,3,0,0,30,51,1,2,0,14,48,11,206,8,3,217,138,355
5141,2,77,0,0,1,14,27,0,1,1,27,25,18,193,4,0,197,80,277
5142,0,20,0,0,0,7,15,14,1,0,14,30,14,115,0,0,115,44,159
5143,0,25,7,1,2,46,39,4,2,1,12,52,35,226,9,2,237,229,466
5144,5,20,2,0,0,92,46,3,1,3,15,47,18,252,1,1,254,158,412
5145,0,5,0,0,1,7,5,1,0,0,2,5,2,28,0,0,28,21,49
5146,0,51,3,1,1,34,42,0,1,1,17,66,73,290,5,0,295,169,464
5147,0,24,1,0,0,18,88,7,1,0,9,43,33,224,10,1,235,165,400
5148,1,26,2,0,0,26,72,10,0,0,6,48,42,233,6,2,241,159,400
5149,0,28,0,1,3,28,76,11,0,3,15,61,62,288,6,0,294,199,493
5150,0,15,1,1,0,11,53,2,2,1,9,69,57,221,2,3,226,97,323
5151,0,11,0,0,0,21,54,1,0,0,20,62,81,250,4,0,254,96,350
5152,0,6,0,0,0,9,73,1,0,1,15,52,41,198,4,2,204,126,330
5153,0,39,3,0,2,12,43,3,1,0,5,52,17,177,7,2,186,126,312
5154,1,1,0,1,1,1,17,0,0,1,1,12,11,47,1,0,48,59,107
5155,0,13,0,0,0,4,21,3,0,0,1,7,14,63,5,1,69,59,128
5156,0,22,1,0,0,2,32,0,0,0,10,52,13,132,2,0,134,39,173
5157,1,14,0,0,0,11,58,3,2,1,5,108,12,215,0,1,216,98,314
5158,2,108,1,0,1,25,75,1,1,0,20,79,74,387,2,0,389,211,600
5159,1,99,0,0,3,38,60,2,2,3,16,114,67,405,3,1,409,191,600
5160,0,105,0,0,2,30,78,1,3,2,44,100,51,416,2,1,419,181,600
5161,2,96,1,1,0,19,72,2,2,1,19,109,70,394,3,1,398,202,600
5162,2,99,0,0,0,17,90,1,2,3,25,100,62,401,4,2,407,193,600
5163,0,71,0,0,0,36,75,2,2,1,37,93,83,400,2,0,402,198,600
5164,2,100,2,0,1,37,75,3,4,3,17,89,72,405,3,1,409,191,600
5165,1,101,1,1,3,27,76,1,2,1,24,113,53,404,5,0,409,191,600
5166,1,68,1,0,1,27,74,0,3,0,18,72,55,320,1,0,321,179,500
5167,2,97,0,0,1,24,61,2,2,2,10,74,66,341,2,0,343,157,500
5168,1,77,2,0,0,41,75,0,2,3,17,80,84,382,3,0,385,115,500
5169,3,71,1,0,1,20,58,1,1,1,22,97,77,353,2,0,355,164,519
5170,0,14,0,0,0,4,1,0,0,1,4,20,7,51,2,0,53,22,75
5171,1,38,2,0,1,8,55,0,3,1,11,54,14,188,1,0,189,93,282
5172,0,0,0,0,0,1,9,1,1,1,1,2,5,21,1,2,24,7,31
5173,0,39,1,0,2,20,110,2,3,6,10,93,94,380,2,1,383,197,580
5174,0,27,0,0,1,20,21,3,0,0,15,72,11,170,2,0,172,54,226
5175,0,62,0,1,3,17,78,2,0,3,21,148,16,351,4,1,356,233,589
5176,0,13,1,0,3,3,46,0,0,1,7,16,16,106,4,0,110,34,144
5177,0,24,0,2,0,4,46,1,2,0,13,32,40,164,2,0,166,71,237
5178,0,21,0,0,0,4,26,0,0,0,5,47,16,119,0,0,119,45,164
5179,2,84,3,0,0,20,76,3,2,1,19,116,69,395,0,1,396,179,575
5180,0,76,4,0,0,21,75,3,6,2,16,128,64,395,2,0,397,179,576
5181,0,5,0,0,0,1,2,0,1,0,0,8,7,24,1,0,25,29,54
5182,0,13,0,0,0,1,30,0,0,0,20,11,13,88,4,0,92,20,112
5183,0,69,0,2,1,19,95,1,0,0,17,83,32,319,2,0,321,165,486
5184,0,80,1,0,1,22,74,5,2,2,16,68,55,326,3,0,329,156,485
5185,0,28,0,1,0,7,86,0,0,0,15,66,22,225,1,1,227,120,347
5186,0,31,0,0,0,11,84,0,0,0,9,10,75,220,4,1,225,127,352
5187,0,7,0,0,0,12,24,0,0,2,4,9,18,76,2,0,78,19,97
5188,0,25,0,1,0,10,29,1,1,1,26,10,39,143,0,1,144,48,192
5189,0,0,0,0,0,9,1,0,0,0,5,7,9,31,0,1,32,57,89
5190,1,55,0,1,2,24,158,10,1,3,17,66,61,399,4,0,403,191,594
5191,0,19,0,0,0,18,48,4,2,0,7,84,36,218,4,1,223,91,314
5192,2,26,0,0,2,13,42,4,0,0,45,89,87,310,2,0,312,188,500
5193,1,35,0,0,1,25,37,3,0,2,65,72,66,307,5,0,312,188,500
5194,1,51,0,0,0,24,80,4,1,3,50,84,74,372,4,0,376,193,569
5195,0,2,0,1,0,2,5,0,0,0,6,7,3,26,0,0,26,34,60
5196,2,60,0,0,1,43,59,6,8,0,24,74,37,314,2,4,320,140,460
5197,0,76,0,0,3,49,66,7,4,1,30,54,36,326,4,2,332,128,460
5198,0,71,2,0,5,38,65,3,3,0,21,54,33,295,5,2,302,158,460
5199,1,74,1,0,3,44,62,8,6,2,23,56,45,325,3,2,330,157,487
5200,0,2,0,0,0,0,10,0,0,0,1,0,2,15,1,0,16,8,24
5201,0,100,2,1,3,9,53,6,2,1,32,43,37,289,1,0,290,110,400
5202,2,83,1,1,2,27,58,6,4,4,29,71,33,321,6,2,329,166,495
5203,0,4,0,0,1,16,29,0,0,1,1,15,8,75,0,0,75,20,95
5204,1,23,1,1,1,6,81,9,0,0,8,103,19,253,4,1,258,118,376
5205,0,23,0,0,2,12,52,6,1,0,12,7,19,134,1,0,135,76,211
5206,0,14,1,0,0,25,58,3,0,1,6,14,17,139,1,1,141,57,198
5207,0,8,0,0,0,9,41,1,1,1,8,13,14,96,1,1,98,66,164
5208,0,13,0,0,0,17,24,3,0,1,7,9,20,94,5,0,99,63,162
5209,1,19,0,0,0,6,12,3,1,1,5,12,22,82,0,0,82,75,157
5210,0,41,0,0,4,25,49,2,2,4,16,164,23,330,8,3,341,167,508
5211,0,47,0,0,2,27,43,3,2,1,20,141,29,315,7,0,322,187,509
5212,2,20,1,0,0,17,51,3,1,4,12,103,42,256,6,1,263,180,443
5213,0,9,0,0,0,9,14,3,0,0,7,11,13,66,3,0,69,36,105
5214,0,8,0,0,0,10,44,2,0,0,12,3,14,93,1,0,94,39,133
5215,4,34,3,1,1,20,80,5,0,4,2,45,22,221,14,2,237,111,348
5216,1,17,0,1,0,15,22,4,1,5,4,17,9,96,0,0,96,66,162
5217,0,14,0,0,2,26,49,2,3,4,7,49,7,163,11,1,175,98,273
5218,3,17,1,0,0,25,14,1,0,1,8,18,15,103,2,0,105,47,152
5219,1,9,0,1,7,18,47,1,1,1,6,21,14,127,2,2,131,100,231
5220,0,51,0,1,0,33,80,7,1,3,7,89,27,299,5,1,305,190,495
5221,1,12,1,1,0,19,56,4,2,3,3,50,20,172,9,3,184,89,273
5222,0,7,1,0,0,7,30,1,0,0,2,18,12,78,0,2,80,41,121
5223,0,7,2,0,1,7,24,6,3,1,4,30,9,94,2,1,97,78,175
5224,1,23,1,0,1,18,33,1,2,1,8,33,7,129,3,0,132,55,187
5225,1,12,0,1,0,2,24,0,0,2,1,73,16,132,3,2,137,63,200
5226,1,31,1,0,1,28,80,1,0,2,3,100,50,298,5,1,304,296,600
5227,0,50,0,0,3,22,74,2,0,1,11,76,62,301,7,2,310,290,600
5228,0,41,2,0,3,27,51,1,0,2,12,91,44,274,4,1,279,271,550
5229,1,32,0,0,0,17,106,1,2,2,5,63,42,271,4,0,275,275,550
5230,0,39,2,0,0,35,56,3,3,2,4,75,59,278,5,1,284,266,550
5231,2,36,1,0,1,34,79,0,1,2,19,66,50,291,3,1,295,255,550
5232,0,52,0,0,1,29,41,1,1,0,8,75,59,267,1,0,268,282,550
5233,1,38,0,0,0,39,80,0,1,2,9,75,47,292,5,1,298,252,550
5234,0,51,0,2,0,26,64,2,0,0,11,126,49,331,4,2,337,237,574
5235,0,22,0,0,1,27,44,5,0,1,6,46,22,174,2,1,177,131,308
5236,0,15,0,1,0,11,51,3,0,0,0,30,36,147,3,2,152,171,323
5237,0,3,0,0,0,10,37,1,1,0,2,31,12,97,3,3,103,91,194
5238,0,17,0,1,0,15,18,0,0,0,3,8,9,71,2,2,75,51,126
5239,0,23,0,0,0,13,40,2,0,0,1,85,26,190,7,0,197,234,431
5240,0,18,0,2,1,46,34,2,0,2,4,47,40,196,9,2,207,220,427
5241,2,25,0,2,1,31,61,0,1,1,6,38,47,215,6,1,222,206,428
5242,2,24,1,1,1,10,49,2,2,2,4,140,21,259,1,0,260,240,500
5243,0,20,1,1,1,15,47,3,0,1,4,128,27,248,4,3,255,245,500
5244,1,17,0,0,0,14,56,3,2,1,3,94,23,214,4,1,219,281,500
5245,0,18,2,1,3,14,62,2,1,3,3,96,24,229,6,1,236,264,500
5246,0,28,0,0,0,11,65,4,1,1,8,165,31,314,4,2,320,269,589
5247,0,2,1,0,0,3,3,1,0,3,2,26,7,48,5,0,53,28,81
5248,0,5,0,0,0,2,19,1,0,3,1,70,13,114,2,0,116,85,201
5249,0,16,1,2,0,2,52,3,3,1,2,105,29,216,6,1,223,182,405
5250,0,9,0,0,1,0,18,0,0,0,1,23,25,77,1,1,79,65,144
5251,1,7,1,0,0,1,54,0,0,3,2,40,7,116,0,0,116,57,173
5252,0,27,1,0,1,15,84,0,1,1,3,81,89,303,3,4,310,213,523
5253,0,8,0,0,0,14,37,0,0,0,1,15,16,91,5,1,97,51,148
5254,0,4,0,0,0,3,23,0,1,0,0,6,12,49,0,0,49,52,101
5255,0,12,0,0,1,50,41,0,0,0,0,54,48,206,1,2,209,241,450
5256,0,11,0,0,0,39,46,0,0,0,1,80,42,219,0,2,221,229,450
5257,0,12,0,0,0,35,45,1,1,2,3,66,28,193,4,1,198,249,447
5258,0,122,0,0,1,38,121,1,1,1,18,67,49,419,4,1,424,176,600
5259,0,113,0,0,0,44,86,3,0,2,21,57,64,390,3,2,395,205,600
5260,1,122,0,0,0,49,117,3,0,0,20,40,42,394,4,0,398,152,550
5261,0,118,0,0,0,62,74,0,1,1,14,58,55,383,4,1,388,164,552
5262,1,41,0,0,0,15,44,0,0,0,10,9,23,143,4,1,148,107,255
5263,0,28,0,0,0,64,37,0,1,0,6,35,4,175,1,2,178,97,275
5264,0,14,1,0,1,19,75,4,2,1,3,63,26,209,3,0,212,88,300
5265,0,23,1,0,2,19,78,2,0,1,3,83,27,239,2,2,243,145,388
5266,0,11,0,0,1,19,48,0,0,0,4,7,34,124,2,0,126,56,182
5267,0,12,0,0,0,15,38,13,0,0,1,11,4,94,0,3,97,45,142
5268,0,56,0,2,0,12,42,0,2,1,3,18,59,195,8,3,206,116,322
5269,0,7,0,0,1,7,22,4,1,0,8,30,3,83,1,1,85,30,115
5270,0,5,0,0,0,15,39,0,0,0,3,5,46,113,2,1,116,57,173
5271,0,5,0,0,0,3,32,1,0,0,2,0,24,67,1,0,68,25,93
5272,2,15,0,1,1,19,65,3,0,2,3,10,32,153,3,0,156,101,257
5273,3,26,0,0,1,27,32,0,1,6,2,127,28,253,10,3,266,113,379
5274,0,44,2,1,1,21,42,1,0,3,10,27,35,187,3,0,190,111,301
5275,0,11,0,0,0,15,29,24,0,2,4,11,15,111,3,0,114,40,154
5276,0,34,0,1,0,33,129,0,2,2,5,10,21,237,1,0,238,138,376
5277,0,72,0,2,7,46,84,3,2,3,24,41,99,383,7,2,392,208,600
5278,2,71,0,0,4,51,100,2,4,0,21,35,101,391,1,0,392,208,600
5279,1,64,2,1,3,52,108,3,7,0,19,57,80,397,3,2,402,198,600
5280,0,74,0,0,2,46,116,1,4,1,31,38,76,389,3,0,392,198,590
5281,0,2,1,0,0,24,5,0,0,0,2,46,7,87,1,0,88,86,174
5282,0,73,0,0,2,62,58,1,5,1,21,65,94,382,3,0,385,165,550
5283,2,61,0,0,4,44,57,0,5,1,17,64,78,333,2,1,336,214,550
5284,1,77,1,0,3,49,99,2,6,0,24,52,66,380,4,0,384,166,550
5285,1,74,0,0,4,38,62,0,3,3,10,57,84,336,2,1,339,211,550
5286,1,62,0,0,5,58,69,1,6,1,37,36,52,328,4,1,333,217,550
5287,3,55,1,0,2,43,84,1,9,0,25,54,63,340,3,1,344,209,553
5288,0,65,0,0,1,45,59,1,2,2,35,68,50,328,5,0,333,167,500
5289,0,72,0,0,0,63,61,1,0,3,20,44,64,328,0,1,329,171,500
5290,1,64,0,2,4,42,73,2,3,2,24,39,65,321,1,0,322,178,500
5291,1,56,1,0,3,47,52,4,4,1,22,35,55,281,2,2,285,147,432
5292,0,5,0,0,2,41,86,0,1,1,4,60,72,272,2,2,276,123,399
5293,2,38,0,1,2,43,87,3,1,1,15,125,36,354,3,0,357,267,624
5294,1,6,0,0,0,6,17,3,0,0,0,14,10,57,1,0,58,46,104
5295,0,19,0,0,1,55,20,0,0,0,4,23,33,155,2,0,157,113,270
5296,2,21,0,1,2,22,29,1,0,1,23,43,60,205,8,3,216,213,429
5297,0,31,0,0,0,28,39,0,1,1,22,26,39,187,7,0,194,234,428
5298,0,7,0,0,2,23,53,3,0,0,8,20,35,151,8,1,160,110,270
5299,0,6,3,0,1,37,21,0,0,2,7,58,16,151,8,3,162,177,339
5300,0,1,1,1,3,31,15,0,0,1,15,64,26,158,4,1,163,175,338
5301,0,16,0,0,0,19,29,2,0,1,11,17,28,123,6,1,130,100,230
5302,0,29,0,0,1,39,26,4,1,0,17,49,47,213,7,0,220,201,421
5303,1,17,0,0,1,39,41,4,1,2,13,64,45,228,7,0,235,186,421
5304,1,6,0,0,9,17,28,3,0,7,6,98,24,199,12,3,214,229,443
5305,2,5,2,2,3,17,39,2,1,10,13,136,25,257,5,0,262,181,443
5306,1,36,1,0,1,28,66,2,0,1,10,53,34,233,1,1,235,157,392
5307,0,34,0,0,2,47,70,1,0,3,14,50,28,249,2,2,253,139,392
5308,1,26,0,0,1,21,33,2,1,0,18,66,26,195,1,0,196,168,364
5309,1,73,1,0,2,40,69,3,0,4,13,85,64,355,6,0,361,239,600
5310,1,65,3,1,3,41,63,0,1,2,15,88,46,329,5,2,336,264,600
5311,6,56,4,1,2,30,81,1,0,1,11,71,57,321,7,1,329,271,600
5312,0,62,0,0,1,40,63,3,2,5,16,96,45,333,0,1,334,254,588
5313,1,12,0,0,1,20,41,3,0,0,12,47,31,168,3,1,172,163,335
5314,0,12,1,0,1,13,39,1,0,2,7,38,50,164,1,1,166,168,334
5315,0,10,0,0,1,6,28,0,0,1,2,7,4,59,0,0,59,30,89
5316,0,2,0,0,1,14,15,1,0,2,2,16,4,57,2,0,59,38,97
5317,0,3,0,0,0,1,9,3,0,0,0,2,5,23,0,0,23,26,49
5318,1,25,0,0,5,33,72,6,4,0,6,27,13,192,1,0,193,157,350
5319,1,43,0,0,3,22,69,1,1,1,6,20,13,180,4,3,187,167,354
5320,2,59,1,1,1,39,65,0,0,0,8,103,18,297,3,0,300,124,424
5321,0,15,0,0,0,2,27,2,0,1,1,2,5,55,3,0,58,16,74
5322,1,26,0,0,1,57,66,0,0,1,26,30,35,243,4,2,249,144,393
5323,0,11,0,0,0,2,30,1,1,0,1,8,4,58,0,0,58,40,98
5324,4,20,1,0,3,17,42,2,0,1,1,20,14,125,2,4,131,124,255
5325,0,3,0,0,0,6,18,0,0,1,2,5,6,41,1,1,43,15,58
5326,1,33,1,2,2,45,90,3,2,3,10,57,21,270,6,0,276,147,423
5327,3,10,0,0,0,86,15,0,0,0,1,107,4,226,3,0,229,188,417
5328,1,12,0,0,1,22,40,0,0,3,10,19,8,116,0,0,116,70,186
5329,0,50,1,0,1,15,48,2,1,1,3,26,37,185,2,0,187,97,284
5330,0,6,0,0,0,48,23,0,0,2,9,77,10,175,1,1,177,79,256
5331,0,5,0,0,0,0,10,0,0,0,1,0,5,21,0,0,21,11,32
5332,0,54,0,0,1,50,42,3,0,3,6,160,26,345,8,3,356,244,600
5333,2,33,5,0,0,35,33,8,2,1,7,173,32,331,5,3,339,261,600
5334,1,44,0,3,1,52,35,4,3,2,4,150,25,324,1,0,325,275,600
5335,1,28,0,1,0,42,33,7,2,2,17,131,20,284,2,0,286,260,546
5336,1,10,1,0,1,19,16,0,0,2,4,43,2,99,0,0,99,109,208
5337,0,24,0,0,1,3,3,2,0,0,7,21,5,66,4,0,70,75,145
5338,1,21,0,1,0,52,23,1,0,0,10,76,7,192,3,1,196,158,354
5339,0,10,3,0,2,53,25,4,0,1,2,70,15,185,3,0,188,165,353
5340,0,11,0,1,0,63,32,1,0,0,2,43,14,167,6,1,174,86,260
5341,0,3,0,0,0,8,15,0,0,0,0,2,1,29,0,0,29,26,55
5342,0,16,0,0,0,28,16,1,1,1,1,11,7,82,2,0,84,88,172
5343,0,1,0,1,0,15,21,0,0,2,0,19,2,61,1,0,62,37,99
5344,0,5,2,0,0,9,8,3,2,0,6,90,7,132,2,0,134,101,235
5345,0,5,0,0,1,60,16,1,1,1,4,14,4,107,1,0,108,49,157
5346,0,8,1,0,4,28,10,4,0,0,5,110,8,178,1,0,179,87,266
5347,0,2,1,0,1,26,18,1,0,1,0,30,3,83,3,0,86,69,155
5348,0,10,0,0,9,36,26,6,1,2,8,130,29,257,9,2,268,117,385
5349,0,11,0,0,1,27,37,2,1,0,5,135,16,235,7,0,242,258,500
5350,1,16,0,0,2,28,26,0,0,0,10,143,20,246,3,2,251,249,500
5351,1,12,1,2,1,18,24,2,0,1,9,143,19,233,9,2,244,209,453
5352,0,1,0,0,3,8,43,1,1,1,11,84,28,181,4,1,186,129,315
5353,0,15,0,1,3,12,30,1,1,0,11,30,41,145,0,3,148,99,247
5354,2,70,1,1,27,50,98,3,1,5,21,54,27,360,5,6,371,237,608
5355,1,13,0,2,7,5,32,4,0,0,1,17,8,90,1,0,91,22,113
5356,0,37,1,1,3,50,43,2,0,2,14,122,71,346,4,1,351,249,600
5357,4,31,0,0,1,33,50,1,1,1,12,122,55,311,6,1,318,282,600
5358,0,34,0,0,2,34,46,2,2,2,19,132,50,323,9,0,332,268,600
5359,0,33,1,2,2,56,36,3,3,1,17,130,60,344,4,0,348,252,600
5360,1,23,0,1,1,41,47,7,1,1,14,131,71,339,7,0,346,254,600
5361,0,47,0,1,4,32,34,3,0,3,13,130,46,313,4,0,317,283,600
5362,2,28,1,0,4,32,45,3,0,2,17,132,49,315,2,2,319,281,600
5363,0,40,0,0,2,43,44,1,1,0,15,132,45,323,3,1,327,273,600
5364,0,25,0,1,2,33,45,2,2,0,15,121,44,290,2,1,293,307,600
5365,0,35,1,0,0,44,32,1,0,1,21,137,61,333,1,2,336,264,600
5366,1,34,1,0,4,49,41,3,3,2,21,120,59,338,3,0,341,259,600
5367,1,20,2,0,0,44,48,4,3,3,22,135,58,340,10,0,350,250,600
5368,2,29,2,1,3,40,37,1,4,1,14,126,61,321,3,1,325,275,600
5369,2,32,1,0,2,47,40,5,1,0,19,134,52,335,3,1,339,261,600
5370,1,37,0,0,3,31,41,3,1,4,21,109,35,286,12,0,298,252,550
5371,0,37,1,2,1,39,43,4,1,1,12,111,50,302,9,3,314,236,550
5372,2,25,0,1,6,36,40,1,2,1,24,112,52,302,3,1,306,244,550
5373,1,71,2,1,2,36,66,5,2,3,27,130,60,406,8,0,414,166,580
5374,2,18,0,0,0,20,32,5,1,0,11,102,32,223,1,0,224,170,394
5375,1,32,1,1,4,43,48,0,5,2,13,81,33,264,3,1,268,232,500
5376,0,22,1,0,3,29,53,2,1,1,11,106,33,262,2,0,264,236,500
5377,3,32,1,0,4,30,36,3,5,2,14,103,28,261,8,2,271,229,500
5378,1,42,0,0,4,33,67,3,3,1,15,116,28,313,1,1,315,255,570
5379,0,26,0,0,0,35,23,2,2,0,10,79,68,245,1,1,247,81,328
5380,2,15,0,1,3,34,39,4,1,0,14,125,38,276,6,1,283,254,537
5381,1,22,2,1,3,36,39,3,4,3,16,118,51,299,4,0,303,234,537
5382,2,42,0,0,0,38,32,3,2,2,15,130,48,314,4,1,319,218,537
5383,1,33,0,0,0,42,47,1,2,3,12,121,45,307,2,0,309,228,537
5384,0,36,1,2,2,39,36,1,2,1,7,116,53,296,7,0,303,234,537
5385,1,20,0,1,2,25,39,2,2,1,10,136,42,281,9,2,292,245,537
5386,1,25,0,0,0,19,39,1,1,3,10,117,38,254,2,1,257,280,537
5387,1,36,2,2,2,34,31,2,1,1,15,129,42,298,4,2,304,296,600
5388,1,44,0,0,3,24,41,2,3,2,26,140,30,316,1,1,318,282,600
5389,1,23,1,0,3,38,32,2,4,3,18,129,42,296,1,1,298,302,600
5390,0,39,0,1,1,34,38,1,0,1,10,153,37,315,6,0,321,279,600
5391,0,25,0,0,1,31,38,2,2,3,15,141,31,289,2,0,291,309,600
5392,0,37,1,0,2,47,35,0,0,1,29,135,23,310,4,1,315,285,600
5393,0,42,0,1,3,35,34,2,4,0,31,130,40,322,5,2,329,271,600
5394,0,28,0,1,3,31,33,4,1,2,26,135,45,309,2,0,311,319,630
5395,0,1,0,1,0,2,6,0,0,2,0,1,10,23,0,0,23,15,38
5396,0,164,0,1,4,38,43,2,0,2,24,51,43,372,5,1,378,217,595
5397,2,109,1,1,3,39,51,4,0,0,28,101,30,369,0,2,371,229,600
5398,1,113,1,1,5,44,53,1,1,3,33,83,30,369,5,2,376,224,600
5399,1,119,1,0,1,48,45,4,3,3,32,85,40,382,1,0,383,217,600
5400,3,140,0,0,0,24,36,3,1,0,34,52,22,315,3,0,318,170,488
5401,1,75,0,1,3,14,34,0,2,0,13,36,27,206,1,0,207,117,324
5403,0,19,0,0,2,12,15,1,0,0,15,116,23,203,3,0,206,119,325
5404,3,33,0,2,1,23,24,5,2,0,7,133,29,262,1,1,264,236,500
5405,1,25,0,0,1,22,32,1,1,0,8,129,42,262,4,1,267,233,500
5406,0,35,0,1,1,12,23,2,2,0,9,123,27,235,3,1,239,261,500
5407,0,35,0,0,1,11,54,7,1,0,5,108,42,264,2,1,267,233,500
5408,0,24,0,0,2,20,42,4,1,0,11,149,34,287,5,0,292,267,559
5409,0,41,0,1,0,23,9,3,1,3,6,29,41,157,5,0,162,144,306
5410,2,22,2,0,0,6,10,4,0,0,3,52,25,126,3,1,130,99,229
5411,0,9,0,0,1,14,24,1,0,0,4,79,6,138,3,0,141,127,268
5412,0,6,0,0,0,2,18,2,0,0,0,13,2,43,0,0,43,40,83
5413,0,6,0,0,0,15,8,3,1,0,3,53,4,93,1,0,94,82,176
5414,0,3,0,1,0,5,10,0,0,1,2,29,12,63,0,2,65,47,112
5415,0,29,0,0,1,36,17,2,1,1,4,77,9,177,5,2,184,132,316
5416,0,21,0,1,0,23,25,6,4,2,5,31,12,130,2,1,133,127,260
5417,1,41,2,0,2,25,23,5,6,2,8,133,15,263,2,4,269,302,571
5418,0,55,0,0,1,46,44,0,1,1,30,106,50,334,7,0,341,259,600
5419,1,48,4,1,3,48,44,2,3,5,41,95,52,347,3,2,352,248,600
5420,0,49,1,0,1,41,55,1,3,0,20,121,49,341,1,1,343,257,600
5421,1,57,1,2,0,38,50,0,3,2,26,107,52,339,3,1,343,257,600
5422,0,40,0,2,3,43,45,1,2,1,33,108,57,335,6,1,342,258,600
5423,1,42,2,0,1,44,42,1,3,0,26,119,46,327,2,0,329,271,600
5424,2,33,0,1,3,45,48,3,3,3,31,89,49,310,5,1,316,284,600
5425,0,42,0,2,4,59,43,0,4,1,31,109,45,340,5,0,345,255,600
5426,0,33,1,2,0,48,27,1,5,2,16,129,51,315,3,0,318,232,550
5427,0,30,0,1,0,48,43,2,3,2,23,89,41,282,5,1,288,262,550
5428,0,48,2,1,0,53,41,1,11,0,21,87,41,306,3,2,311,239,550
5429,1,43,1,0,2,28,49,1,1,0,30,84,48,288,4,0,292,261,553
5430,0,18,0,2,0,23,36,1,1,0,16,124,41,262,6,1,269,331,600
5431,3,21,0,0,1,42,46,1,0,0,27,112,40,293,9,0,302,298,600
5432,2,13,1,0,1,30,42,0,1,0,23,139,47,299,3,0,302,298,600
5433,1,20,1,0,2,34,38,2,3,2,25,116,46,290,7,1,298,302,600
5434,1,20,1,0,0,31,46,0,0,0,22,105,51,277,9,0,286,314,600
5435,2,17,2,0,1,30,58,2,0,2,24,113,36,287,5,0,292,307,599
5436,1,17,1,0,0,35,54,3,0,2,30,121,44,308,7,0,315,285,600
5437,0,15,0,0,0,34,53,1,2,2,23,87,26,243,4,0,247,303,550
5438,1,18,1,0,2,28,52,2,1,0,25,92,34,256,2,1,259,291,550
5439,1,16,0,1,2,27,50,0,0,2,27,110,30,266,8,1,275,265,540
5440,0,14,1,0,0,24,50,1,1,0,27,84,35,237,0,0,237,247,484
5441,3,1,0,0,0,10,14,1,1,1,18,179,5,233,2,3,238,139,377
5442,3,18,0,0,4,20,20,2,1,1,8,120,21,218,2,2,222,130,352
5443,1,39,1,0,3,48,55,3,2,3,21,88,49,313,2,0,315,185,500
5444,1,32,2,0,0,35,68,2,0,2,17,88,36,283,5,1,289,171,460
5445,0,0,0,0,0,5,8,3,0,0,0,4,6,26,0,0,26,28,54
5446,3,86,0,0,2,64,51,3,11,0,22,99,71,412,4,1,417,183,600
5447,2,67,0,1,5,58,52,3,6,2,23,101,70,390,1,1,392,208,600
5448,0,67,0,2,2,74,74,1,2,3,24,104,78,431,1,0,432,168,600
5449,1,95,0,0,6,65,50,1,3,1,36,99,55,412,6,2,420,180,600
5450,0,68,2,0,6,67,67,2,1,1,24,101,67,406,3,0,409,191,600
5451,2,61,2,0,3,64,74,3,3,0,21,97,61,391,2,1,394,206,600
5452,1,73,1,4,2,47,60,1,6,2,28,108,64,397,5,0,402,198,600
5453,0,76,0,1,0,69,51,4,3,0,25,68,68,365,4,0,369,181,550
5454,0,66,1,2,2,53,58,2,1,5,25,88,66,369,0,1,370,180,550
5455,2,70,0,1,1,62,59,1,0,4,19,90,47,356,3,0,359,191,550
5456,0,69,2,2,4,63,60,2,7,3,18,74,64,368,1,0,369,181,550
5457,1,53,0,0,6,47,65,1,5,0,22,67,61,328,2,0,330,194,524
5458,0,7,1,0,0,3,34,4,3,5,3,28,9,97,4,0,101,243,344
5459,0,3,1,0,0,3,33,5,1,0,4,40,7,97,3,1,101,221,322
5460,1,20,0,1,2,49,51,5,0,0,18,109,33,289,5,0,294,306,600
5461,2,22,1,0,1,54,36,2,1,2,10,116,31,278,2,0,280,320,600
5462,1,28,0,0,4,43,38,2,1,1,19,99,38,274,7,0,281,319,600
5463,0,22,1,0,1,44,61,1,1,1,9,104,31,276,5,0,281,329,610
5464,4,35,1,0,2,40,26,1,2,0,16,104,39,270,4,0,274,226,500
5465,0,37,0,0,2,37,23,2,2,1,11,122,32,269,3,0,272,228,500
5466,2,28,0,0,1,27,27,2,3,1,20,117,36,264,4,0,268,242,510
5467,1,3,0,1,0,0,11,2,0,0,0,10,1,29,0,0,29,41,70
5468,0,11,0,0,0,6,27,1,0,0,6,36,15,102,1,0,103,29,132
5469,0,31,0,1,0,7,18,3,0,0,2,40,35,137,2,0,139,96,235
5470,0,13,0,0,1,3,51,9,0,0,4,35,9,125,0,0,125,46,171
5471,0,72,1,2,4,50,105,0,1,2,26,93,53,409,1,1,411,189,600
5472,0,74,1,0,5,44,73,4,0,0,23,136,41,401,4,0,405,195,600
5473,1,86,0,0,5,36,85,4,2,0,30,95,52,396,1,0,397,203,600
5474,1,58,1,3,4,31,88,3,2,3,39,104,50,387,1,1,389,211,600
5475,1,61,2,0,3,37,96,2,2,1,30,113,61,409,3,0,412,188,600
5476,2,89,1,0,2,34,76,1,2,1,16,119,70,413,1,0,414,186,600
5477,0,75,1,0,2,34,84,2,4,0,35,121,57,415,1,1,417,183,600
5478,1,59,0,0,2,30,88,6,1,1,35,121,58,402,0,1,403,197,600
5479,2,76,0,2,2,41,66,1,1,1,29,114,75,410,2,0,412,188,600
5480,0,55,0,0,1,40,80,5,4,0,41,104,60,390,5,0,395,205,600
5481,0,52,2,0,0,37,76,5,1,2,36,110,68,389,0,0,389,211,600
5482,2,87,0,0,1,37,77,0,5,2,35,106,50,402,3,1,406,194,600
5483,0,75,0,0,3,41,82,1,1,0,25,100,61,389,1,0,390,160,550
5484,0,55,0,1,3,35,72,2,5,2,25,109,74,383,2,0,385,165,550
5485,0,58,2,2,3,31,70,3,2,2,33,127,64,397,3,1,401,164,565
5486,0,45,0,0,5,30,52,1,0,1,20,94,48,296,1,0,297,203,500
5487,0,33,0,1,1,38,68,4,5,1,22,103,27,303,0,1,304,196,500
5488,0,27,0,1,3,29,51,2,1,1,12,91,33,251,4,1,256,194,450
5489,0,18,0,2,1,33,58,1,0,0,22,114,20,269,2,2,273,179,452
5490,2,66,0,1,4,56,73,3,7,1,26,103,55,397,7,1,405,143,548
5491,1,77,1,0,1,60,76,1,3,1,27,94,43,385,2,0,387,161,548
5492,0,58,2,0,1,45,61,4,4,2,28,125,46,376,4,2,382,166,548
5493,1,62,2,1,2,39,83,3,5,3,25,116,54,396,0,0,396,152,548
5494,0,58,1,0,3,44,84,0,1,2,28,91,73,385,1,1,387,161,548
5495,2,35,0,0,2,40,84,5,1,1,15,118,39,342,5,1,348,252,600
5496,2,31,2,0,0,39,70,4,1,0,14,129,36,328,2,1,331,269,600
5497,1,34,1,1,3,25,71,3,1,0,12,115,39,306,6,0,312,237,549
5498,0,34,3,0,1,9,52,2,4,0,30,76,75,286,3,2,291,109,400
5499,0,30,0,0,5,20,27,2,1,0,45,59,107,296,3,0,299,147,446
5500,0,0,0,0,1,0,4,1,0,0,4,1,1,12,1,1,14,13,27
5501,1,44,0,0,5,31,56,2,3,4,28,114,55,343,2,1,346,204,550
5502,3,44,1,0,2,41,67,6,2,0,30,132,45,373,2,1,376,174,550
5503,0,59,4,0,2,29,62,5,3,2,30,117,50,363,0,0,363,187,550
5504,2,52,2,1,4,31,46,3,0,1,23,150,38,353,5,0,358,192,550
5505,2,52,1,1,4,29,50,4,1,4,27,114,33,322,5,2,329,186,515
5506,0,15,1,0,3,23,55,2,2,0,6,41,11,159,5,0,164,89,253
5507,0,29,2,0,1,21,90,1,1,1,34,70,39,289,3,3,295,153,448
5508,0,46,0,0,0,5,11,0,1,0,8,13,21,105,2,0,107,31,138
5509,0,44,3,0,4,17,96,4,0,1,10,83,46,308,8,1,317,134,451
5510,0,21,0,0,0,10,7,0,0,0,12,10,21,81,0,0,81,22,103
5511,0,0,0,0,1,6,20,0,0,0,2,14,5,48,1,0,49,16,65
5512,0,17,0,0,0,20,78,1,0,0,13,64,43,236,1,0,237,111,348
5513,0,14,0,0,0,12,34,0,0,0,11,9,17,97,2,1,100,46,146
5514,0,12,0,0,0,2,17,0,0,0,5,7,15,58,0,0,58,25,83
5515,0,16,1,0,4,19,47,4,2,3,6,120,65,287,10,0,297,256,553
5516,1,15,0,0,0,18,69,3,1,0,12,137,41,297,7,2,306,214,520
5517,1,16,1,0,2,26,43,4,1,1,6,136,25,262,5,2,269,250,519
5518,0,4,0,0,0,4,5,0,0,0,1,38,20,72,1,0,73,54,127
5519,0,29,2,1,3,52,54,2,4,5,24,123,42,341,3,0,344,256,600
5520,3,32,2,2,2,59,39,6,6,5,12,123,54,345,6,0,351,249,600
5521,1,34,0,1,1,84,39,8,4,0,12,114,32,330,10,1,341,259,600
5522,0,27,2,0,2,70,36,1,3,5,16,142,38,342,6,2,350,250,600
5523,0,39,0,0,4,57,40,1,3,4,19,115,41,323,5,1,329,271,600
5524,1,45,0,2,1,79,38,7,3,2,20,114,33,345,5,2,352,248,600
5525,1,40,0,1,0,52,42,2,2,2,28,130,37,337,1,1,339,261,600
5526,0,35,0,0,1,65,41,6,15,2,23,109,48,345,1,1,347,253,600
5527,0,30,2,0,1,43,47,4,2,2,29,131,36,327,3,1,331,269,600
5528,0,37,2,0,1,44,34,5,3,4,18,139,35,322,4,2,328,282,610
5529,1,31,0,0,0,77,36,6,8,4,24,126,22,335,5,0,340,270,610
5530,3,35,1,1,0,98,43,6,13,3,27,94,29,353,4,0,357,255,612
5531,0,5,0,0,0,27,27,2,0,1,10,55,10,137,3,0,140,144,284
5532,2,32,1,1,14,15,43,4,12,6,4,80,13,227,3,1,231,201,432
5533,1,14,1,0,0,44,28,2,1,16,11,105,18,241,7,0,248,200,448
5534,1,17,0,0,2,21,31,0,2,13,12,70,21,190,9,0,199,248,447
5535,1,2,0,0,0,12,44,2,0,4,2,27,6,100,1,0,101,46,147
5536,2,10,2,0,0,13,37,2,0,2,4,79,20,171,0,2,173,222,395
5537,2,11,1,0,1,13,30,2,1,1,1,74,19,156,2,2,160,236,396
5538,0,18,1,1,1,40,48,3,0,4,15,56,18,205,8,1,214,163,377
5539,0,14,0,0,0,7,5,0,1,0,1,3,1,32,0,1,33,36,69
5540,0,0,3,1,20,5,17,1,1,5,4,40,23,120,3,1,124,215,339
5541,1,12,0,0,3,20,23,2,1,2,4,19,22,109,3,1,113,125,238
5542,3,8,1,1,2,51,28,5,2,1,2,72,34,210,3,0,213,224,437
5543,1,9,0,0,0,17,18,1,0,0,6,75,55,182,4,2,188,140,328
5544,1,9,0,0,1,15,21,4,0,3,4,72,58,188,3,2,193,135,328
5545,0,26,0,0,2,41,41,1,3,5,17,118,21,275,5,0,280,320,600
5546,1,24,0,0,2,50,34,4,4,2,24,148,24,317,7,1,325,275,600
5547,0,23,0,1,1,49,27,2,1,2,14,166,25,311,4,0,315,285,600
5548,0,22,1,0,1,31,37,5,2,2,12,135,24,272,4,1,277,323,600
5549,1,23,0,1,4,33,39,4,3,2,31,128,31,300,3,0,303,297,600
5550,0,18,2,1,1,40,42,4,7,2,13,132,23,285,4,1,290,253,543
5551,0,2,0,0,7,3,7,0,1,0,0,5,6,31,0,1,32,86,118
5552,0,14,0,0,0,31,51,8,2,3,18,133,37,297,5,1,303,297,600
5553,0,18,1,1,3,42,62,12,2,3,21,146,30,341,10,4,355,249,604
5554,3,24,2,0,4,19,68,2,2,3,10,138,38,313,1,1,315,298,613
5555,1,22,2,1,0,22,33,3,0,1,0,67,24,176,2,0,178,191,369
5556,2,23,1,1,8,17,46,7,3,1,7,97,75,288,4,0,292,233,525
5557,2,12,3,0,0,33,79,0,1,1,8,81,27,247,7,1,255,278,533
5558,4,16,0,1,0,38,55,2,0,3,13,82,21,235,3,2,240,260,500
5559,0,8,1,0,1,16,44,2,1,1,9,75,26,184,2,1,187,215,402
5560,1,7,1,1,0,18,42,3,1,1,5,44,43,167,1,0,168,140,308
5561,0,9,2,0,1,12,50,3,2,1,6,131,9,226,2,1,229,197,426
5562,2,33,2,2,14,22,26,4,1,0,17,138,107,368,7,0,375,193,568
5563,1,16,4,0,17,8,42,0,0,1,2,62,10,163,1,0,164,254,418
5564,1,8,0,0,18,11,43,1,0,0,0,82,7,171,5,1,177,241,418
5565,0,5,1,0,0,3,2,3,1,0,2,10,5,32,0,0,32,26,58
5566,0,6,0,0,8,20,39,10,0,1,5,70,16,175,2,0,177,114,291
5567,0,7,0,1,1,21,18,4,1,1,1,60,30,145,6,1,152,148,300
5568,0,82,1,1,11,40,43,2,1,6,9,67,40,303,2,3,308,292,600
5569,2,94,1,1,6,14,64,3,1,2,12,69,29,298,6,1,305,297,602
5570,1,78,0,0,6,17,33,2,1,4,5,48,14,209,2,1,212,166,378
5571,0,15,0,0,1,16,5,1,1,2,7,17,9,74,4,1,79,167,246
5572,0,12,1,0,0,2,20,1,1,0,4,29,6,76,5,1,82,105,187
5573,0,3,0,0,0,10,25,0,0,1,1,3,16,59,1,1,61,78,139
5574,2,31,3,0,0,5,64,2,2,1,11,66,29,216,3,2,221,204,425
5575,0,11,1,1,3,11,39,3,1,0,13,91,37,211,9,0,220,240,460
5576,1,3,0,0,1,5,22,0,0,0,5,28,4,69,1,0,70,62,132
5577,1,26,3,0,1,21,19,0,0,2,15,38,36,162,1,0,163,178,341
5578,3,24,0,0,1,19,31,0,0,0,2,18,25,123,1,5,129,105,234
5579,0,11,0,2,2,10,49,2,3,2,6,56,44,187,4,1,192,152,344
5580,0,11,2,0,0,22,36,3,1,0,3,32,24,134,2,0,136,125,261
5581,1,19,2,1,2,17,92,7,0,3,8,40,29,221,7,1,229,235,464
5582,0,3,0,0,0,3,7,2,0,1,1,4,8,29,1,1,31,72,103
5583,0,1,0,0,0,18,23,3,0,1,12,68,44,170,3,1,174,94,268
5584,0,5,1,0,0,9,28,5,0,0,10,24,7,89,4,4,97,123,220
5585,1,2,0,0,0,0,3,4,1,0,0,10,1,22,1,0,23,26,49
5586,0,0,0,0,0,0,7,0,0,0,1,13,4,25,0,1,26,32,58
5587,0,1,0,0,0,2,17,4,0,0,0,8,14,46,7,2,55,76,131
5588,0,10,0,2,0,9,17,0,0,0,2,33,34,107,2,0,109,125,234
5589,0,4,0,0,0,10,42,2,0,4,1,28,5,96,3,1,100,81,181
5590,1,33,0,2,1,12,73,4,0,1,8,88,36,259,11,1,271,257,528
5591,0,12,1,0,1,13,66,1,0,2,5,54,7,162,5,2,169,172,341
5592,1,19,1,1,3,16,66,1,2,0,5,45,12,172,4,3,179,162,341
5593,0,23,0,0,0,10,101,4,0,0,8,44,44,234,6,0,240,165,405
5594,0,18,0,0,0,5,92,2,0,0,5,37,48,207,1,0,208,192,400
5595,1,10,0,1,1,31,84,5,0,1,15,165,38,352,11,2,365,180,545
5596,0,16,0,0,0,25,71,4,3,3,19,175,30,346,6,1,353,193,546
5597,0,12,0,1,1,28,55,1,1,1,4,50,14,168,5,3,176,145,321
5598,3,78,1,1,3,32,55,1,2,3,14,105,84,382,3,1,386,164,550
5599,0,85,2,0,3,48,43,2,2,5,8,122,48,368,4,0,372,178,550
5600,0,101,0,1,1,34,58,4,1,2,8,116,43,369,4,0,373,177,550
5601,0,66,1,0,5,24,59,0,2,1,13,128,55,354,1,0,355,195,550
5602,0,61,0,1,3,26,53,3,5,3,9,137,55,356,8,0,364,186,550
5603,1,79,2,0,3,34,52,0,1,0,18,118,58,366,5,1,372,178,550
5604,1,85,2,0,3,23,41,6,5,0,10,133,71,380,4,2,386,164,550
5605,0,72,2,0,4,22,63,3,1,1,13,131,45,357,3,1,361,189,550
5606,3,65,0,1,3,35,35,0,3,1,13,99,43,301,3,1,305,156,461
5607,1,17,0,0,1,13,54,1,1,0,11,29,8,136,2,0,138,77,215
5608,0,11,0,0,0,3,14,0,0,1,1,10,8,48,3,0,51,24,75
5609,0,9,1,0,0,16,3,0,1,1,2,46,4,83,0,0,83,56,139
5610,0,0,0,0,0,4,10,0,1,0,0,2,8,25,0,0,25,14,39
5611,0,40,0,0,1,22,24,4,2,2,12,155,46,308,2,1,311,139,450
5612,1,42,1,0,2,19,33,1,0,0,8,129,47,283,4,0,287,163,450
5613,2,61,1,1,1,27,21,6,2,0,6,142,32,302,8,1,311,164,475
5614,0,16,0,0,0,12,48,0,1,0,3,41,10,131,0,0,131,63,194
5615,0,52,0,1,0,16,30,1,0,2,7,49,17,175,3,0,178,90,268
5616,0,22,0,0,0,2,114,1,1,3,7,81,14,245,1,2,248,89,337
5617,0,11,0,0,0,7,16,0,0,0,2,74,10,120,0,1,121,46,167
5618,1,4,0,0,0,3,4,0,0,2,5,7,8,34,1,0,35,27,62
5619,1,67,0,0,2,37,56,5,2,0,14,146,77,407,8,0,415,206,621
5620,0,67,1,1,2,32,57,7,3,1,12,150,76,409,2,1,412,210,622
5621,3,23,1,1,0,29,32,4,1,1,9,81,50,235,3,2,240,160,400
5622,0,42,1,1,0,16,34,2,1,2,8,98,48,253,0,1,254,146,400
5623,2,35,1,0,1,22,45,3,5,5,11,112,53,295,7,1,303,163,466
5624,1,32,2,0,4,28,53,8,0,0,12,93,32,265,5,0,270,280,550
5625,1,27,1,0,2,46,80,2,1,2,10,79,45,296,3,1,300,250,550
5626,2,30,0,0,1,37,56,1,0,1,17,72,43,260,5,0,265,285,550
5627,2,34,0,0,1,48,69,1,2,3,10,93,41,304,6,0,310,240,550
5628,1,21,3,0,3,38,70,3,1,2,13,55,53,263,2,0,265,285,550
5629,0,23,0,0,3,44,70,0,1,0,8,69,37,255,3,4,262,205,467
5630,1,20,0,0,2,15,29,2,0,0,12,65,26,172,4,0,176,189,365
5631,1,10,1,1,2,17,27,2,2,1,10,67,28,169,4,1,174,192,366
5632,0,17,1,0,1,14,7,0,0,1,6,187,25,259,2,0,261,237,498
5633,1,6,0,0,2,18,37,1,0,0,5,83,12,165,3,1,169,149,318
5634,2,31,2,0,0,29,35,5,1,1,8,81,14,209,5,4,218,182,400
5635,1,20,5,0,0,50,56,3,1,0,11,57,17,221,6,0,227,173,400
5636,0,20,2,0,3,51,51,3,3,2,5,77,27,244,7,0,251,233,484
5637,0,5,0,0,0,1,38,4,0,0,0,14,1,63,1,1,65,51,116
5638,1,36,2,1,2,48,41,1,3,2,42,123,36,338,4,1,343,257,600
5639,2,32,4,0,4,56,53,1,4,2,26,108,24,316,7,0,323,277,600
5640,1,20,1,0,7,31,38,3,4,3,39,106,32,285,3,0,288,212,500
5641,2,32,1,1,5,42,48,2,2,0,22,98,18,273,6,1,280,220,500
5642,0,28,3,0,1,47,47,1,2,0,29,111,18,287,6,1,294,206,500
5643,1,32,1,0,0,22,20,5,1,0,38,91,14,225,2,0,227,197,424
5644,2,37,3,0,0,26,49,2,1,1,11,93,25,250,6,1,257,243,500
5645,1,21,3,0,6,42,52,2,0,0,10,76,25,238,1,0,239,260,499
5646,0,44,4,0,3,31,41,3,5,2,16,87,28,264,5,0,269,267,536
5647,1,9,1,1,2,12,35,1,0,1,25,112,7,207,5,0,212,131,343
5648,1,9,3,0,0,17,39,2,1,1,22,56,15,166,3,0,169,181,350
5649,0,7,1,2,0,14,24,3,1,1,12,81,10,156,7,0,163,177,340
5650,0,29,3,0,4,16,62,3,2,0,35,101,25,280,4,1,285,258,543
5651,0,10,1,0,5,27,46,2,2,1,30,121,13,258,7,2,267,275,542
5652,0,6,1,2,32,6,16,1,0,1,11,68,7,151,5,0,156,196,352
5653,0,4,0,0,0,15,17,0,0,0,19,32,10,97,2,0,99,112,211
5655,1,1,0,0,1,0,9,0,0,1,0,4,7,24,0,1,25,18,43
5656,3,10,1,1,0,29,25,7,0,0,14,91,31,212,5,2,219,221,440
5657,0,6,0,1,3,26,16,2,0,0,11,104,29,198,0,1,199,242,441
5658,0,1,0,1,0,8,7,0,1,0,1,12,3,34,0,1,35,72,107
5659,0,1,3,0,1,1,5,1,0,2,0,22,7,43,0,1,44,23,67
5660,0,18,0,1,0,15,13,2,0,1,2,58,13,123,1,0,124,128,252
5661,0,1,0,1,1,1,33,2,1,0,2,34,5,81,0,0,81,41,122
5662,1,2,0,0,0,4,4,0,0,0,7,30,4,52,2,0,54,47,101
5663,0,3,0,0,0,8,13,1,0,0,2,31,1,59,1,0,60,71,131
5664,0,5,1,0,2,11,11,2,0,0,3,43,5,83,3,0,86,36,122
5665,0,16,0,0,0,17,43,0,1,0,6,69,17,169,3,0,172,163,335
5666,1,12,1,0,2,17,34,1,2,1,4,112,13,200,3,0,203,132,335
5667,3,24,0,1,6,13,36,5,5,1,12,110,33,249,6,1,256,244,500
5668,1,28,3,0,1,25,40,3,2,1,12,112,20,248,2,1,251,249,500
5669,2,35,2,0,1,23,53,2,5,0,12,104,22,261,7,2,270,230,500
5670,0,32,0,0,2,25,30,0,2,0,4,117,23,235,12,1,248,171,419
5671,1,16,3,0,2,66,39,2,0,2,20,143,14,308,3,0,311,295,606
5672,0,16,0,2,2,37,38,6,0,1,17,141,12,272,12,0,284,321,605
5673,0,16,0,0,1,10,24,3,0,3,10,80,32,179,5,0,184,129,313
5674,0,20,0,0,2,21,23,2,0,1,5,78,8,160,5,0,165,129,294
5675,1,26,1,1,3,41,50,6,0,1,27,94,23,274,4,2,280,295,575
5676,2,31,1,1,3,39,33,3,0,0,14,100,20,247,7,0,254,321,575
5677,1,0,0,0,0,11,13,1,0,1,2,29,7,65,1,1,67,36,103
5678,1,23,1,2,1,17,34,1,1,1,5,137,16,240,4,0,244,355,599
5679,1,2,1,0,1,6,2,1,0,1,7,12,4,38,4,0,42,34,76
5680,0,1,0,0,0,6,14,1,0,0,4,34,0,60,6,1,67,54,121
5681,0,9,1,1,2,16,13,0,1,1,1,40,3,88,2,1,91,122,213
5682,0,4,0,1,0,10,2,0,0,1,4,9,19,50,5,1,56,33,89
5683,4,53,2,0,2,55,36,1,3,2,14,106,43,321,4,1,326,274,600
5684,1,56,1,0,2,54,44,2,5,5,26,92,57,345,4,0,349,251,600
5685,1,42,2,0,1,28,42,5,1,1,12,104,35,274,2,0,276,224,500
5686,1,33,0,1,1,34,39,1,4,1,9,82,43,249,8,4,261,239,500
5687,2,46,0,0,1,46,43,2,1,1,11,69,49,271,1,1,273,227,500
5688,4,33,0,1,0,40,32,1,4,0,22,84,35,256,0,0,256,244,500
5689,1,39,0,0,1,39,34,4,2,2,9,88,54,273,1,2,276,224,500
5690,2,62,1,0,2,50,33,4,4,1,15,99,54,327,4,0,331,252,583
5691,1,10,0,0,0,7,27,0,0,0,1,129,5,180,2,0,182,117,299
5692,3,31,0,0,0,15,37,4,3,1,13,114,51,272,6,1,279,227,506
5693,1,6,0,1,1,17,36,2,1,2,20,140,24,251,2,2,255,234,489
5694,2,16,2,1,1,23,65,4,2,2,15,100,18,251,2,0,253,236,489
5695,1,11,0,1,0,35,41,5,1,1,5,129,33,263,1,0,264,313,577
5696,0,5,0,0,0,3,13,0,0,0,3,32,27,83,1,1,85,78,163
5697,2,45,4,1,0,41,52,3,0,1,7,105,47,308,2,1,311,207,518
5698,2,27,1,1,0,32,57,2,2,0,6,87,48,265,3,2,270,248,518
5699,0,30,2,0,1,51,27,2,1,1,4,136,49,304,6,1,311,289,600
5700,1,27,1,0,3,28,45,3,1,1,9,123,46,288,3,1,292,308,600
5701,0,22,1,0,1,27,40,2,0,0,9,104,27,233,5,2,240,260,500
5702,3,20,0,1,0,27,48,2,1,3,8,107,62,282,2,0,284,216,500
5703,0,18,1,1,3,23,42,5,1,0,9,149,31,283,3,2,288,212,500
5704,2,19,3,0,0,34,26,2,1,1,8,124,28,248,8,0,256,244,500
5705,0,30,2,0,0,30,34,1,3,0,9,122,33,264,4,0,268,270,538
5706,0,42,2,0,2,28,24,2,2,1,8,79,34,224,2,0,226,224,450
5707,4,32,0,0,3,39,19,3,1,0,7,65,23,196,3,0,199,201,400
5708,0,33,0,0,1,31,17,1,0,4,8,97,29,221,3,1,225,198,423
5709,1,45,0,0,4,39,41,4,4,0,11,116,25,290,3,1,294,306,600
5710,2,46,0,0,2,56,42,1,3,1,17,71,53,294,4,1,299,292,591
5711,1,10,2,0,0,13,30,6,0,0,6,130,48,246,8,0,254,315,569
5712,0,5,0,0,0,0,2,1,1,1,0,0,2,12,0,0,12,8,20
5713,1,4,1,0,2,15,26,1,0,0,5,30,7,92,0,0,92,66,158
5714,6,24,5,0,1,64,96,3,1,1,13,100,40,354,10,1,365,254,619
5715,0,19,0,1,2,36,65,6,1,5,16,125,14,290,3,1,294,182,476
5716,0,1,0,0,0,9,3,0,5,0,5,20,5,48,0,0,48,24,72
5717,0,12,0,0,0,3,12,0,0,2,1,13,3,46,0,0,46,29,75
5718,0,1,0,0,0,9,7,0,0,1,2,10,6,36,0,2,38,24,62
5719,0,15,0,0,3,16,85,0,1,5,9,83,54,271,4,0,275,139,414
5720,0,14,1,0,2,3,24,0,1,4,0,24,12,85,1,0,86,53,139
5721,1,15,0,0,1,29,30,12,0,0,14,52,59,213,3,6,222,98,320
5722,0,56,3,2,0,31,82,2,7,1,22,98,28,332,3,0,335,188,523
5723,5,42,0,1,1,43,66,4,2,1,28,92,20,305,6,0,311,212,523
5724,0,24,0,0,3,38,78,2,1,2,22,72,76,318,3,2,323,192,515
5725,0,21,1,1,0,10,28,3,1,1,10,94,21,191,8,1,200,192,392
5726,1,17,0,2,0,18,52,1,4,2,4,104,22,227,4,3,234,158,392
5727,0,7,1,1,0,18,17,1,2,0,5,48,19,119,0,1,120,161,281
5728,1,28,1,0,2,49,54,0,1,3,10,74,50,273,3,1,277,323,600
5729,1,41,0,0,4,52,43,1,2,2,21,76,56,299,5,0,304,296,600
5730,0,32,2,0,4,35,37,0,3,1,12,74,41,241,4,1,246,354,600
5731,1,43,0,3,1,44,52,4,0,1,16,61,36,262,2,2,266,334,600
5732,0,43,0,1,2,40,62,3,1,4,8,63,33,260,4,2,266,334,600
5733,0,40,0,1,1,38,43,1,1,1,14,80,54,274,10,0,284,266,550
5734,1,41,0,0,1,32,45,0,0,3,20,65,34,242,8,0,250,288,538
5735,0,0,0,0,2,6,6,0,0,0,0,4,11,29,3,1,33,93,126
5736,0,18,3,1,1,29,42,0,1,0,4,118,40,257,5,3,265,346,611
5737,0,25,1,1,4,27,42,2,0,0,12,98,31,243,9,0,252,359,611
5738,2,21,1,0,0,26,45,1,1,1,9,82,33,222,2,1,225,386,611
5739,1,27,0,0,6,24,45,3,0,3,6,90,39,244,7,0,251,361,612
5740,1,23,0,0,2,21,66,0,0,1,13,46,14,187,4,0,191,219,410
5741,0,5,0,0,0,9,12,0,0,1,2,1,2,32,4,1,37,87,124
5742,1,39,2,1,2,46,60,1,1,2,16,96,33,300,5,1,306,305,611
5743,2,24,0,0,0,50,40,3,4,2,11,90,34,260,7,0,267,344,611
5744,0,19,1,0,2,13,78,3,1,1,6,75,23,222,7,0,229,213,442
5745,0,3,1,0,0,0,7,1,0,0,1,1,2,16,0,0,16,7,23
5746,1,40,0,0,2,24,33,3,0,2,9,86,46,246,3,1,250,250,500
5747,2,41,2,0,2,29,33,2,1,2,8,100,37,259,3,1,263,237,500
5748,3,37,0,0,3,26,15,3,1,1,4,123,28,244,3,2,249,251,500
5749,0,57,0,0,3,42,25,7,0,0,12,74,24,244,5,1,250,250,500
5750,0,44,1,0,2,28,24,1,1,1,10,106,26,244,5,0,249,204,453
5751,5,25,4,3,3,17,48,1,2,6,29,124,19,286,3,3,292,308,600
5752,3,18,2,0,0,27,63,3,2,1,36,116,24,295,6,3,304,306,610
5753,1,28,1,0,1,41,62,1,0,1,32,101,19,288,6,1,295,312,607
5754,0,32,0,1,1,26,24,4,0,1,24,124,9,246,6,0,252,298,550
5755,1,14,0,0,0,32,29,7,0,2,37,118,16,256,7,0,263,310,573
5756,0,33,1,1,1,13,19,2,0,3,6,103,5,187,5,3,195,155,350
5757,0,31,1,0,3,18,18,0,0,2,7,80,12,172,13,2,187,164,351
5758,0,8,0,0,0,1,6,0,1,0,1,5,9,31,0,0,31,51,82
5759,0,23,0,0,3,27,54,2,3,0,4,129,28,273,9,0,282,293,575
5760,1,23,1,2,2,22,73,2,0,0,8,142,19,295,4,2,301,274,575
5761,1,26,3,2,2,35,68,3,2,4,4,137,31,318,4,1,323,277,600
5762,1,33,1,0,4,36,55,6,1,3,13,120,36,309,11,0,320,280,600
5763,0,31,2,1,3,19,47,2,0,1,15,111,46,278,6,2,286,264,550
5764,0,23,2,0,1,35,50,3,0,0,8,125,34,281,6,1,288,262,550
5765,0,39,0,0,1,23,50,1,1,1,18,126,28,288,2,1,291,259,550
5766,1,37,3,0,4,27,65,3,1,2,10,138,23,314,4,0,318,232,550
5767,2,22,2,1,5,28,54,3,0,1,8,123,32,281,6,0,287,263,550
5768,2,39,2,1,3,33,45,1,2,5,8,126,30,297,4,2,303,247,550
5769,2,27,2,0,1,22,57,1,0,2,7,145,23,289,0,0,289,260,549
5770,1,21,1,0,1,33,38,1,3,3,10,136,40,288,3,0,291,259,550
5771,1,29,3,0,1,25,52,1,2,4,20,127,40,305,3,0,308,245,553
5772,0,1,0,1,0,4,7,5,0,0,4,16,3,41,1,0,42,46,88
5773,1,1,1,0,0,6,3,0,0,1,1,21,7,42,0,0,42,28,70
5774,1,2,1,0,0,0,24,0,0,0,0,17,1,46,0,0,46,15,61
5775,0,7,0,0,1,6,18,2,0,0,2,29,11,76,1,0,77,80,157
5776,0,24,1,1,1,21,57,1,0,0,13,69,18,206,9,0,215,168,383
5777,1,28,0,1,0,20,49,13,0,3,5,81,11,212,0,0,212,167,379
5778,1,3,1,0,0,11,32,2,0,0,4,41,2,97,1,0,98,51,149
5779,0,28,1,1,3,23,61,2,0,0,7,170,21,317,0,0,317,213,530
5780,1,27,0,1,4,28,36,2,0,0,11,173,20,303,6,2,311,219,530
5781,0,14,2,1,2,26,56,6,0,2,1,141,22,273,2,0,275,217,492
5782,0,19,2,0,2,16,41,3,1,1,5,92,25,207,3,0,210,240,450
5783,1,20,0,0,1,31,36,2,1,3,3,86,19,203,0,0,203,225,428
5784,1,16,0,0,0,29,17,4,0,1,1,21,25,115,2,1,118,132,250
5785,1,3,0,0,0,4,18,1,0,0,3,7,4,41,1,0,42,50,92
5786,2,14,2,0,1,32,35,5,1,1,7,33,32,165,7,0,172,242,414
5787,27,0,1,3,3,16,20,1,0,3,15,50,17,156,6,0,162,113,275
5788,0,40,2,0,3,24,22,4,2,1,19,72,25,214,6,1,221,200,421
5789,0,4,2,0,2,0,6,1,0,3,1,9,1,29,0,0,29,172,201
5790,0,14,3,0,2,2,2,1,1,0,11,56,24,116,3,1,120,96,216
5791,1,12,6,1,5,3,30,2,2,1,4,61,25,153,7,5,165,117,282
5792,0,3,1,2,2,9,13,0,0,0,3,28,73,134,4,2,140,81,221
5793,0,30,0,0,0,21,51,12,0,3,3,77,13,210,3,2,215,154,369
5794,1,15,3,0,0,14,20,1,2,1,5,158,20,240,5,1,246,144,390
5795,2,12,0,0,0,25,38,4,5,2,8,34,23,153,4,1,158,193,351
5796,0,60,2,0,2,35,75,5,1,2,6,117,65,370,0,1,371,229,600
5797,1,53,1,0,1,22,41,3,3,1,7,93,55,281,2,2,285,265,550
5798,0,58,0,0,1,38,68,1,1,2,7,86,74,336,1,2,339,211,550
5799,3,64,2,1,3,22,57,1,0,1,19,88,67,328,4,3,335,215,550
5800,5,55,3,0,4,25,62,2,2,0,12,118,61,349,7,0,356,194,550
5801,0,57,1,2,2,20,45,5,2,0,14,113,55,316,5,0,321,233,554
5802,1,42,0,0,0,31,56,4,0,2,9,116,30,291,0,1,292,246,538
5803,1,35,3,0,0,27,54,4,0,1,19,67,33,244,3,1,248,252,500
5804,0,37,0,1,0,28,67,1,0,1,9,72,30,246,6,2,254,226,480
5805,32,0,4,0,0,8,36,4,1,4,13,60,36,198,6,3,207,114,321
5806,2,73,0,1,1,22,76,3,2,4,10,100,57,351,5,4,360,188,548
5807,3,46,1,0,1,13,47,4,2,0,15,84,48,264,2,1,267,155,422
5808,2,22,0,0,4,9,56,8,2,1,16,78,60,258,3,0,261,189,450
5809,0,47,2,1,1,15,50,6,6,0,7,91,52,278,5,2,285,155,440
5810,0,10,1,0,0,4,36,1,0,1,3,52,18,126,1,0,127,54,181
5811,2,32,2,2,3,27,52,2,3,3,8,96,31,263,8,1,272,178,450
5812,0,30,4,2,1,13,60,4,0,2,16,83,47,262,1,0,263,187,450
5813,1,49,2,1,2,15,55,3,2,0,13,129,43,315,5,3,323,166,489
5814,0,2,0,0,1,0,7,1,0,0,0,3,4,18,1,0,19,5,24
5815,1,27,2,1,0,22,41,3,0,0,19,124,36,276,4,2,282,242,524
5816,1,41,0,1,1,55,62,6,0,1,5,85,35,293,1,1,295,305,600
5817,1,37,3,0,1,40,48,6,0,2,9,98,33,278,6,0,284,316,600
5818,2,42,1,1,0,42,57,7,0,0,7,99,26,284,6,0,290,310,600
5819,1,52,0,1,4,31,48,5,1,2,14,104,21,284,5,1,290,310,600
5820,2,52,1,0,2,31,44,9,0,3,8,128,26,306,3,1,310,290,600
5821,6,31,2,0,0,23,36,12,0,1,9,84,22,226,4,0,230,299,529
5822,0,21,1,0,1,28,47,9,5,3,15,66,22,218,4,4,226,324,550
5823,1,24,2,0,1,28,35,2,0,3,4,79,30,209,7,2,218,336,554
5824,1,20,0,2,2,34,46,6,1,0,5,80,58,255,5,0,260,237,497
5825,1,11,1,0,0,10,59,5,1,1,5,51,75,220,3,0,223,168,391
5826,1,15,3,1,0,20,38,8,2,1,8,47,89,233,3,0,236,155,391
5827,1,13,0,0,1,3,14,4,7,1,2,33,27,106,5,1,112,61,173
5828,0,18,0,3,3,23,55,2,2,0,13,54,38,211,5,0,216,224,440
5829,2,32,1,0,2,23,55,5,1,0,10,72,31,234,1,1,236,203,439
5830,0,9,0,0,0,16,28,4,0,2,5,18,4,86,1,0,87,78,165
5831,1,26,0,0,2,27,72,5,0,0,14,169,29,345,4,0,349,267,616
5832,0,54,4,1,2,26,81,5,1,0,32,106,38,350,3,2,355,245,600
5833,2,50,2,0,1,43,93,2,0,0,20,107,42,362,12,0,374,226,600
5834,3,52,4,1,4,42,81,6,1,1,18,105,46,364,8,2,374,226,600
5835,1,46,1,0,0,31,129,1,0,1,15,87,35,347,4,1,352,232,584
5836,0,14,0,2,0,24,57,0,1,1,5,27,15,146,11,0,157,186,343
5837,1,21,1,1,2,9,52,1,0,0,4,33,11,136,6,1,143,200,343
5839,1,39,0,1,1,20,45,3,0,0,8,68,13,199,2,0,201,192,393
5840,2,28,0,2,1,38,52,3,0,1,10,54,46,237,7,1,245,147,392
5841,0,15,0,0,0,4,17,2,1,0,9,46,12,106,1,0,107,80,187
5842,1,14,0,0,0,6,57,3,0,3,4,36,16,140,1,1,142,88,230
5843,0,20,2,0,0,30,103,3,0,1,14,94,42,309,3,0,312,194,506
5844,2,10,1,0,0,12,33,0,0,0,3,42,9,112,1,1,114,79,193
5845,0,34,0,0,1,34,54,0,1,1,8,61,30,224,2,0,226,143,369
5846,1,29,1,0,8,13,38,2,1,1,12,61,27,194,3,1,198,163,361
5847,1,52,1,1,3,64,63,0,1,3,5,90,30,314,11,1,326,201,527
5848,1,2,0,0,0,4,43,0,0,1,0,13,6,70,0,0,70,22,92
5849,0,6,0,0,0,10,14,1,2,0,1,23,5,62,0,0,62,51,113
5850,1,26,1,0,7,22,26,0,0,1,9,54,32,179,4,1,184,130,314
5851,0,13,1,2,1,3,42,6,1,3,6,67,49,194,8,2,204,320,524
5852,0,22,0,0,0,6,41,5,1,3,6,89,34,207,6,2,215,310,525
5853,0,4,0,0,1,2,3,0,1,0,4,29,4,48,0,0,48,31,79
5854,1,12,1,0,0,4,68,2,3,1,12,94,16,214,2,2,218,163,381
5855,2,31,0,1,1,11,71,5,0,1,12,86,30,251,4,1,256,266,522
5856,0,13,0,0,1,23,47,0,0,2,2,28,33,149,2,1,152,88,240
5857,0,15,1,0,0,8,36,4,0,0,1,22,14,101,5,1,107,107,214
5858,2,6,1,1,5,6,24,3,0,1,8,96,43,196,1,0,197,139,336
5859,0,22,2,0,1,12,55,0,2,2,5,80,24,205,5,2,212,135,347
5860,1,16,3,0,4,13,39,2,3,1,18,65,28,193,6,4,203,144,347
5861,1,25,1,1,0,10,62,2,1,0,14,153,32,302,5,1,308,199,507
5862,3,2,3,0,2,4,16,5,0,1,17,88,22,163,3,3,169,115,284
5863,1,25,0,1,1,16,31,6,0,1,4,60,47,193,7,2,202,243,445
5864,0,25,3,1,2,10,40,0,3,2,4,98,30,218,5,3,226,174,400
5865,1,38,0,0,0,11,44,0,0,4,3,107,46,254,3,0,257,154,411
5866,1,12,1,0,0,14,48,4,0,0,9,81,36,206,3,2,211,215,426
5867,1,24,0,1,5,22,74,4,0,1,10,121,59,322,4,2,328,222,550
5868,0,20,0,1,0,31,87,3,0,1,9,98,61,311,1,1,313,237,550
5869,2,21,1,1,1,19,81,4,1,1,6,93,52,283,5,1,289,247,536
5870,0,35,0,1,0,30,56,4,0,1,9,62,28,226,6,1,233,235,468
5871,0,3,0,0,0,11,34,5,0,1,9,25,1,89,0,1,90,67,157
5872,0,6,0,0,1,3,14,5,0,2,3,52,20,106,3,1,110,59,169
5873,1,20,1,0,1,24,39,5,1,0,5,154,52,303,4,2,309,219,528
5874,1,17,0,1,2,20,33,5,2,1,7,158,37,284,7,0,291,237,528
5875,2,18,1,1,3,24,36,3,0,0,8,173,37,306,6,0,312,216,528
5876,0,22,0,0,0,25,50,2,1,0,5,134,53,292,7,0,299,230,529
5877,0,22,0,1,1,44,20,2,0,0,6,104,29,229,3,0,232,110,342
5878,0,23,0,0,0,23,26,2,0,1,13,113,31,232,4,0,236,106,342
5879,1,12,0,0,0,29,67,6,0,2,11,109,44,281,5,2,288,262,550
5880,1,9,0,0,3,26,69,5,0,1,5,119,35,273,6,0,279,280,559
5881,0,8,0,0,0,8,15,2,0,1,1,1,18,54,0,1,55,36,91
5882,2,5,1,0,0,10,30,0,0,0,2,21,17,88,1,1,90,87,177
5883,0,7,2,0,0,11,15,2,1,2,1,43,24,108,3,0,111,57,168
5884,0,2,0,0,0,8,31,1,0,0,3,96,21,162,1,0,163,106,269
5885,1,9,0,0,1,4,24,2,0,1,3,35,47,127,1,0,128,60,188
5886,1,17,0,0,0,8,20,2,0,2,2,25,10,87,1,0,88,52,140
5887,0,6,0,1,3,19,60,3,0,0,16,86,21,215,7,0,222,178,400
5888,1,22,0,1,0,20,73,5,1,1,8,120,22,274,4,3,281,136,417
5889,1,25,0,1,0,28,32,9,1,2,15,116,48,278,10,2,290,249,539
5890,0,2,0,0,0,1,0,0,0,0,2,4,0,9,0,0,9,27,36
5891,0,2,0,0,0,7,36,0,0,0,0,4,2,51,0,0,51,32,83
5892,0,2,0,0,1,2,14,0,0,0,1,18,11,49,1,0,50,28,78
5893,0,13,0,0,2,16,62,3,1,1,6,41,7,152,2,0,154,71,225
5894,0,12,0,0,0,19,15,0,0,0,1,43,13,103,3,0,106,144,250
5895,0,46,2,1,0,26,77,2,3,0,13,138,63,371,5,4,380,220,600
5896,0,44,2,1,2,31,63,6,3,0,16,133,89,390,2,2,394,206,600
5897,1,60,2,3,1,36,69,3,0,2,7,139,58,381,6,1,388,202,590
5898,1,16,1,0,0,18,53,1,0,0,10,44,52,196,1,1,198,178,376
5899,0,13,0,0,2,17,54,3,0,0,3,57,9,158,2,2,162,127,289
5900,2,9,1,1,3,5,24,4,1,1,5,39,7,102,9,4,115,80,195
5901,2,38,0,1,3,33,47,2,0,2,11,134,40,313,8,0,321,279,600
5902,0,34,2,0,0,34,50,0,3,3,19,109,45,299,6,1,306,244,550
5903,0,36,0,1,1,34,58,4,0,2,8,133,39,316,0,2,318,232,550
5904,0,51,1,1,4,29,55,5,0,2,11,125,32,316,3,1,320,230,550
5905,2,43,1,0,3,25,47,2,0,2,12,122,43,302,1,0,303,247,550
5906,1,49,2,0,2,25,58,6,0,1,6,139,41,330,2,0,332,218,550
5907,1,44,3,1,2,28,35,4,2,3,6,143,46,318,9,1,328,222,550
5908,1,35,1,1,1,32,59,4,1,0,9,143,27,314,3,1,318,232,550
5909,1,22,0,0,1,36,35,5,2,1,8,152,41,304,9,0,313,237,550
5910,1,59,0,0,5,26,47,3,2,1,4,136,43,327,4,1,332,218,550
5912,2,50,0,1,2,26,58,3,0,2,8,153,35,340,9,1,350,223,573
5913,3,9,0,0,0,16,41,2,1,0,0,21,4,97,1,0,98,65,163
5914,0,27,1,1,2,6,16,2,3,0,4,50,30,142,2,0,144,117,261
5915,2,6,1,0,1,12,63,3,0,2,5,107,13,215,2,1,218,159,377
5916,1,39,0,0,0,30,58,7,0,1,3,94,17,250,6,1,257,193,450
5917,2,27,1,1,3,16,43,2,0,2,6,112,23,238,9,0,247,203,450
5918,2,23,0,0,1,26,48,2,0,0,10,90,27,229,3,0,232,203,435
5919,1,23,0,0,0,40,64,2,3,5,4,175,49,366,6,1,373,270,643
5920,2,24,1,0,3,34,75,5,1,3,8,92,8,256,4,0,260,184,444
5921,0,2,1,0,0,3,35,0,0,0,7,11,8,67,0,0,67,105,172
5922,2,25,4,1,3,30,40,6,0,3,6,171,23,314,10,3,327,223,550
5923,1,22,3,1,5,33,63,5,0,0,15,146,25,319,6,0,325,225,550
5924,0,33,3,1,2,31,39,7,0,2,12,130,24,284,6,0,290,217,507
5925,0,14,0,0,3,19,14,2,0,1,2,22,14,91,2,0,93,62,155
5926,0,29,1,1,1,31,35,2,4,1,9,103,30,247,6,3,256,194,450
5927,1,21,3,1,2,30,31,0,3,2,5,117,29,245,8,1,254,189,443
5928,1,3,0,0,2,6,33,3,0,2,0,31,49,130,1,2,133,150,283
5929,0,30,0,0,0,23,38,5,0,0,7,172,35,310,11,1,322,278,600
5930,0,16,1,1,2,26,39,4,0,0,8,166,33,296,1,1,298,252,550
5931,0,41,2,0,2,30,39,2,0,1,4,133,26,280,5,0,285,241,526
5932,0,0,0,0,1,1,7,0,0,2,2,2,4,19,0,0,19,14,33
5933,2,26,2,0,3,29,52,5,0,0,6,101,25,251,5,1,257,343,600
5934,1,20,1,0,6,27,50,3,3,0,10,92,38,251,5,0,256,344,600
5935,3,21,3,0,10,31,53,3,0,2,4,101,22,253,5,3,261,289,550
5936,0,26,0,2,9,22,44,1,1,1,6,89,25,226,1,0,227,323,550
5937,3,44,0,1,2,19,62,1,0,1,12,84,37,266,5,1,272,278,550
5938,1,26,3,1,17,22,52,2,1,1,15,79,27,247,5,0,252,309,561
5939,0,36,2,0,1,17,39,1,1,2,8,101,37,245,3,1,249,351,600
5940,2,17,0,1,2,20,35,2,1,1,6,119,27,233,5,0,238,362,600
5941,0,23,2,0,5,26,36,1,1,0,4,93,22,213,7,0,220,380,600
5942,1,33,2,0,2,33,41,2,7,1,8,89,24,243,4,0,247,353,600
5943,1,23,2,0,2,40,37,2,0,0,4,91,18,220,0,0,220,329,549
5944,1,18,0,0,1,15,45,0,0,0,3,85,22,190,6,3,199,201,400
5945,2,20,3,1,2,21,35,0,0,1,8,86,28,207,0,0,207,205,412
5946,0,8,1,1,2,22,56,1,0,5,9,92,60,257,7,7,271,218,489
5947,1,19,3,0,1,23,51,2,0,0,5,42,20,167,3,3,173,96,269
5948,1,11,1,2,0,23,71,4,0,1,3,110,16,243,6,0,249,234,483
5949,0,22,1,1,3,17,49,0,2,3,4,116,27,245,2,2,249,251,500
5951,0,26,4,0,0,29,50,1,1,3,3,120,34,271,4,0,275,265,540
5952,2,15,0,0,0,28,36,1,0,2,5,107,11,207,7,1,215,285,500
5953,0,7,2,0,2,23,40,0,2,1,1,122,13,213,6,2,221,279,500
5954,0,10,3,0,1,22,30,1,0,0,5,97,18,187,8,0,195,305,500
5955,1,21,1,1,5,21,32,3,2,1,1,101,13,203,3,1,207,293,500
5956,0,11,0,1,0,18,32,1,0,3,4,85,16,171,3,0,174,315,489
5957,0,31,1,0,9,28,45,1,1,0,6,147,28,297,4,2,303,297,600
5958,0,27,2,0,3,20,52,5,0,4,5,168,36,322,5,1,328,272,600
5959,2,29,6,1,2,18,61,4,0,2,5,138,30,298,11,3,312,288,600
5960,3,22,2,0,5,28,80,2,1,2,6,158,21,330,12,0,342,268,610
5961,1,35,0,0,2,34,74,6,2,4,8,106,21,293,4,3,300,310,610
5962,2,28,0,1,1,50,77,5,1,1,0,118,25,309,13,1,323,294,617
5963,3,9,2,0,4,31,39,3,3,2,3,149,14,262,5,1,268,193,461
5964,2,11,1,2,1,34,48,2,0,0,8,51,20,180,3,0,183,92,275
5965,0,15,3,0,2,10,125,2,2,4,5,64,7,239,5,3,247,180,427
5966,0,7,2,0,2,16,47,0,1,1,4,117,17,214,11,4,229,172,401
5967,0,8,2,1,1,3,39,2,0,2,3,46,15,122,2,1,125,64,189
5968,1,23,0,0,4,26,65,2,0,1,4,125,17,268,4,1,273,277,550
5969,0,34,0,0,3,31,74,1,2,2,8,126,17,298,5,1,304,246,550
5970,1,16,2,1,1,23,46,3,1,1,6,98,24,223,7,3,233,281,514
5981,0,33,0,1,1,34,79,6,0,1,16,84,40,295,4,1,300,250,550
5982,2,28,1,0,0,40,51,1,1,0,6,77,33,240,3,0,243,266,509
5983,0,11,0,0,0,18,14,0,0,0,0,13,25,81,4,0,85,82,167
5984,0,19,0,0,0,10,28,1,0,0,2,12,13,85,1,0,86,121,207
6001,5,51,0,1,1,44,53,3,0,3,18,78,44,301,1,1,303,247,550
6002,2,51,3,2,3,61,67,1,4,2,13,83,26,318,4,4,326,224,550
6003,1,37,0,0,2,43,53,0,3,2,10,93,38,282,5,4,291,236,527
6004,4,23,0,1,3,54,30,3,0,2,23,116,48,307,3,2,312,288,600
6005,4,22,1,0,2,39,34,5,1,1,21,143,29,302,3,4,309,291,600
6021,1,55,1,1,4,41,71,1,3,5,25,107,56,371,3,3,377,223,600
6022,0,37,3,1,1,51,64,0,1,3,22,115,34,332,2,0,334,266,600
6023,0,46,1,1,4,31,61,6,0,2,21,136,34,343,9,2,354,246,600
6024,0,67,2,2,1,42,52,1,1,1,27,115,35,346,4,4,354,246,600
6025,0,40,2,1,4,45,53,3,2,0,16,90,31,287,4,1,292,208,500
6026,1,58,1,1,2,45,52,1,0,4,15,94,26,300,9,0,309,191,500
6027,3,39,2,1,1,36,36,0,2,3,22,119,29,293,0,2,295,205,500
6041,0,34,1,0,4,44,40,3,3,2,24,83,50,288,7,0,295,205,500
6042,3,37,0,0,1,27,59,2,1,1,22,85,34,272,1,1,274,226,500
6043,2,37,4,1,0,33,47,3,3,0,22,106,29,287,4,2,293,207,500
5654,0,0,0,0,1,5,10,1,0,0,3,26,1,47,3,0,50,71,121
5838,1,24,2,1,0,18,34,0,0,1,10,42,35,168,5,2,175,97,272
5911,2,34,2,0,1,31,43,3,1,0,12,132,34,295,4,0,299,251,550
5950,2,29,2,0,1,26,47,1,0,0,9,120,42,279,4,4,287,213,500
5971,0,47,0,2,0,53,74,2,0,0,8,49,55,290,3,0,293,307,600
5972,1,58,0,0,6,42,60,6,1,3,8,72,51,308,3,0,311,289,600
5973,1,33,1,0,2,57,74,9,0,2,10,63,53,305,0,0,305,295,600
5974,1,42,3,0,1,52,58,6,3,0,8,53,54,281,1,1,283,317,600
5975,2,46,1,0,2,46,75,5,3,2,7,75,57,321,1,0,322,278,600
5976,0,60,1,0,2,45,73,2,3,5,6,69,52,318,0,0,318,282,600
5977,0,41,1,3,2,44,72,4,1,2,8,70,50,298,2,1,301,271,572
5978,2,26,1,1,1,40,68,2,0,2,7,71,41,262,1,1,264,286,550
5979,2,31,1,0,3,35,55,7,0,0,6,78,37,255,2,0,257,293,550
5980,0,35,0,1,3,53,55,5,1,12,0,79,42,286,1,0,287,263,550
5985,2,28,0,0,1,28,120,2,0,2,4,51,37,275,2,3,280,229,509
5986,1,15,0,0,5,51,38,1,0,1,13,101,66,292,9,1,302,266,568
5987,0,20,0,0,3,36,42,6,1,1,8,97,68,282,7,1,290,278,568
5988,0,41,0,0,0,59,73,9,3,1,10,78,74,348,10,1,359,241,600
5989,1,62,0,1,2,48,81,4,0,0,11,73,62,345,4,0,349,251,600
5990,0,63,0,2,0,53,84,6,3,0,9,59,59,338,5,1,344,234,578
5991,1,33,0,0,5,32,90,4,1,3,11,55,50,285,2,0,287,263,550
5992,0,42,0,0,1,19,99,5,1,0,9,37,42,255,2,1,258,285,543
5993,2,46,1,1,4,51,84,3,1,9,16,95,45,358,4,1,363,237,600
5994,5,35,1,2,4,52,67,5,2,4,12,88,43,320,8,2,330,270,600
5995,2,39,3,1,6,41,54,1,1,4,16,116,52,336,4,1,341,259,600
5996,2,34,1,1,1,41,67,2,2,4,14,100,52,321,2,3,326,274,600
5997,4,31,1,2,4,39,68,4,5,4,17,100,32,311,4,3,318,282,600
5998,2,34,0,1,4,51,71,2,3,0,10,100,28,306,7,3,316,284,600
5999,3,35,1,0,2,46,76,5,2,3,14,86,26,299,4,1,304,296,600
6000,3,25,6,2,5,49,65,1,3,9,8,88,43,307,5,2,314,286,600
6006,1,21,0,1,2,46,46,2,3,2,16,122,24,286,8,3,297,303,600
6007,1,24,2,0,4,44,35,2,2,2,16,123,33,288,4,2,294,306,600
6008,4,20,3,3,4,51,48,5,0,2,18,125,28,311,6,2,319,281,600
6009,2,17,3,0,2,55,36,2,1,1,15,134,33,301,5,1,307,293,600
6010,0,20,2,0,2,53,37,3,0,3,21,117,26,284,4,1,289,251,540
6011,1,32,1,1,3,56,49,1,0,4,14,90,29,281,6,3,290,296,586
6012,4,35,2,1,2,35,52,4,2,6,20,132,47,342,5,1,348,252,600
6013,0,38,2,0,3,41,37,4,1,4,23,158,28,339,10,0,349,251,600
6014,1,38,1,1,1,33,45,5,2,5,12,121,30,295,6,0,301,299,600
6015,2,36,0,2,2,37,36,2,4,2,23,144,22,312,4,2,318,282,600
6016,1,45,2,0,5,37,45,1,2,4,17,104,39,302,8,0,310,240,550
6017,2,34,1,1,3,46,45,1,0,5,11,115,34,298,8,3,309,241,550
6018,7,24,1,1,0,49,40,2,2,4,19,134,29,312,5,0,317,233,550
6019,2,40,1,1,3,28,41,2,4,3,12,104,20,261,10,2,273,185,458
6020,2,68,5,0,1,54,48,2,1,4,15,126,44,370,5,0,375,225,600
6028,3,40,0,0,2,32,43,1,3,2,24,108,41,299,5,0,304,196,500
6029,0,47,2,0,1,37,73,0,1,1,21,101,37,321,5,2,328,190,518
6030,1,29,2,0,0,36,27,3,0,3,23,135,26,285,6,2,293,307,600
6031,2,25,3,0,1,32,25,3,3,2,23,164,21,304,3,2,309,291,600
6032,3,18,0,0,2,49,30,0,2,3,19,156,25,307,2,2,311,289,600
6033,2,16,1,0,1,47,24,1,2,3,15,136,25,273,9,1,283,317,600
6034,1,18,0,0,0,27,27,4,4,2,30,153,22,288,5,1,294,306,600
6035,1,19,0,1,2,38,24,7,0,1,23,142,29,287,6,3,296,304,600
6036,0,21,0,1,1,44,24,9,2,0,21,139,29,291,5,2,298,302,600
6037,25,0,1,0,2,43,38,4,4,3,17,164,28,329,4,1,334,266,600
6038,0,20,0,1,0,34,33,2,0,6,23,130,17,266,4,1,271,267,538
6039,1,14,1,1,0,12,19,1,2,0,4,57,15,127,3,1,131,134,265
6040,1,46,0,1,0,37,41,1,2,2,19,83,50,283,4,1,288,212,500
6044,1,35,2,0,1,41,57,2,0,3,27,75,46,290,4,3,297,215,512
6045,0,22,0,0,3,46,21,2,1,2,14,141,9,261,4,1,266,234,500
6046,0,31,2,0,3,40,21,2,4,1,9,160,19,292,5,1,298,202,500
6047,1,17,0,1,0,30,28,5,0,3,13,153,15,266,6,1,273,227,500
6048,2,24,1,0,2,40,35,0,0,0,7,153,18,282,6,2,290,210,500
6049,1,23,0,0,3,43,25,2,3,2,10,126,22,260,4,0,264,214,478
6050,1,25,2,1,0,33,36,1,0,4,25,149,31,308,5,1,314,286,600
6051,4,30,3,1,1,28,29,6,2,6,16,156,30,312,6,3,321,279,600
6052,1,36,2,0,3,40,30,0,0,2,21,159,17,311,8,0,319,281,600
6053,2,23,1,1,1,35,29,2,0,2,24,154,29,303,8,2,313,287,600
6054,0,27,1,0,3,45,42,2,1,2,20,134,26,303,4,3,310,290,600
6055,1,23,1,0,2,33,28,3,0,5,14,164,23,297,5,1,303,297,600
6056,3,32,0,1,1,40,27,2,0,2,10,191,27,336,2,2,340,260,600
6057,3,22,2,1,4,37,29,2,2,4,19,143,30,298,6,2,306,294,600
6058,0,17,2,0,1,43,24,3,2,2,21,146,35,296,8,1,305,295,600
6059,3,22,1,2,3,35,29,4,1,2,15,131,37,285,6,2,293,257,550
6060,0,22,0,1,2,47,30,0,1,3,18,133,27,284,5,2,291,258,549
6061,0,36,3,1,3,63,55,1,0,3,25,107,38,335,4,0,339,261,600
6062,3,36,2,0,1,57,58,3,3,5,19,132,27,346,4,1,351,249,600
6063,2,36,1,1,0,52,64,3,0,3,22,120,19,323,5,1,329,221,550
6064,1,35,0,2,7,51,39,0,1,3,18,120,27,304,6,1,311,239,550
6065,1,27,3,2,2,34,50,3,3,1,20,100,28,274,13,3,290,212,502
6066,2,10,1,0,1,12,18,0,0,2,10,102,27,185,5,0,190,111,301
6067,0,1,0,1,0,0,8,0,0,1,5,2,6,24,0,0,24,3,27
6068,0,29,3,1,5,32,33,2,3,0,18,149,33,308,7,5,320,280,600
6069,1,37,1,1,2,38,42,3,2,3,14,144,27,315,10,3,328,272,600
6070,0,35,3,2,4,33,44,10,2,8,19,151,20,331,6,1,338,262,600
6071,4,36,6,0,2,18,40,3,2,3,19,152,22,307,15,1,323,277,600
6072,2,22,3,3,2,27,49,3,2,4,15,136,17,285,7,2,294,256,550
6073,1,27,2,0,0,30,34,2,4,2,18,144,31,295,17,0,312,238,550
6074,1,27,0,3,6,28,36,1,1,9,10,150,31,303,2,1,306,244,550
6075,1,36,3,1,2,34,26,5,1,5,13,142,24,293,8,2,303,247,550
6076,2,26,3,2,4,38,35,3,1,1,13,119,44,291,4,2,297,288,585
6077,2,56,1,3,2,42,44,1,0,0,8,105,48,312,4,4,320,233,553
6078,1,10,5,0,4,11,26,3,0,1,10,97,53,221,3,2,226,144,370
6079,0,15,5,1,1,14,41,3,1,2,14,85,38,220,3,5,228,144,372
6080,2,22,2,0,3,20,40,6,1,6,16,79,40,237,4,4,245,230,475
6081,0,15,1,0,2,21,56,2,2,1,9,78,45,232,6,3,241,234,475
6082,1,12,5,0,0,5,27,0,0,2,9,84,22,167,11,5,183,307,490
6083,2,11,0,1,1,27,56,3,0,2,8,141,38,290,12,2,304,296,600
6084,0,12,0,1,1,24,38,2,0,4,14,133,34,263,11,2,276,274,550
6085,0,11,0,0,5,41,53,8,1,1,4,131,32,287,4,4,295,259,554
6086,2,6,1,1,1,27,49,10,0,2,2,43,10,154,1,2,157,73,230
6087,2,16,2,0,1,5,54,0,0,3,4,132,13,232,7,0,239,179,418
6088,1,12,3,0,1,5,59,0,1,1,3,164,11,261,1,2,264,146,410
6089,1,4,4,0,0,18,50,4,0,0,11,84,14,190,9,2,201,142,343
6090,2,9,2,0,3,9,36,4,0,1,10,96,15,187,10,4,201,142,343
6091,2,5,5,0,1,16,29,1,1,0,11,139,4,214,6,0,220,120,340
6092,2,7,4,1,0,44,52,8,0,7,15,155,28,323,14,2,339,245,584
6093,0,15,4,2,0,21,63,6,0,6,13,116,26,272,3,1,276,174,450
6094,0,24,2,1,3,24,53,4,0,0,14,99,13,237,5,1,243,207,450
6095,0,15,2,1,1,16,43,6,1,5,16,100,7,213,5,4,222,192,414
6096,0,4,7,1,1,4,13,3,0,0,3,60,56,152,13,6,171,246,417
6097,1,4,2,0,2,1,27,1,0,2,2,83,10,135,1,2,138,424,562
6098,0,2,30,0,0,0,8,1,0,1,8,2,4,56,0,2,58,144,202
6099,2,7,4,2,0,11,105,5,0,2,10,137,1,286,8,4,298,275,573
6100,0,2,1,1,1,0,159,2,2,1,0,7,4,180,5,3,188,191,379
6101,0,1,0,0,2,0,11,1,0,2,2,135,3,157,0,3,160,194,354
6102,0,3,5,0,0,2,6,0,0,0,1,151,5,173,3,2,178,185,363
6103,0,2,0,0,1,0,5,3,0,0,1,0,1,13,1,0,14,36,50
6104,3,27,6,0,2,25,37,7,0,2,8,163,26,306,6,4,316,284,600
6105,1,17,5,0,1,30,16,3,1,0,16,154,29,273,10,2,285,215,500
6106,2,20,6,0,0,13,31,0,1,2,12,133,16,236,2,0,238,262,500
6107,0,13,11,0,2,18,26,0,1,2,10,121,20,224,5,2,231,269,500
6108,2,13,6,0,2,26,28,2,1,1,12,161,17,271,5,2,278,222,500
6109,1,18,4,0,1,22,27,7,0,1,11,134,23,249,8,1,258,247,505
6110,1,22,0,1,2,14,29,1,1,2,19,121,34,247,6,2,255,170,425
6111,0,15,2,1,2,21,34,6,1,0,22,111,32,247,7,1,255,169,424
6112,0,5,1,0,2,10,16,0,1,0,5,39,7,86,1,0,87,60,147
6113,0,16,0,0,3,9,36,1,0,1,7,83,18,174,7,1,182,168,350
6114,4,11,1,1,0,14,26,2,0,3,9,83,18,172,4,1,177,167,344
6115,2,7,0,0,0,7,16,1,0,2,11,77,10,133,6,0,139,81,220
6116,2,9,1,0,1,5,25,0,0,1,4,56,10,114,3,2,119,181,300
6117,3,3,1,1,1,4,44,4,0,2,3,39,10,115,7,1,123,171,294
6118,1,0,0,0,0,3,6,1,0,1,2,6,2,22,1,0,23,21,44
6119,0,18,1,0,3,43,46,2,2,2,15,91,54,277,9,3,289,211,500
6120,4,17,0,0,2,45,43,0,0,3,8,123,51,296,5,2,303,199,502
6121,1,13,0,0,0,19,19,0,0,1,8,49,22,132,3,0,135,88,223
6122,1,11,1,2,6,25,41,1,1,3,5,149,20,266,1,0,267,254,521
6123,2,10,0,1,3,19,43,2,0,1,10,130,23,244,5,3,252,269,521
6124,2,21,1,1,2,31,38,5,1,0,13,87,22,224,4,3,231,219,450
6125,0,17,2,0,1,27,34,5,1,0,11,117,23,238,7,3,248,202,450
6126,0,15,0,2,3,38,39,0,2,2,11,85,17,214,3,1,218,208,426
6127,2,6,0,0,0,17,26,1,0,4,3,83,20,162,3,1,166,134,300
6128,2,8,1,0,1,21,32,2,0,1,4,70,19,161,4,3,168,103,271
6129,3,20,2,1,1,37,24,5,3,0,17,159,32,304,5,2,311,260,571
6130,0,18,0,1,2,43,25,3,1,1,6,153,22,275,2,1,278,293,571
6131,2,99,1,1,3,41,89,2,4,1,12,129,50,434,2,0,436,164,600
6132,0,71,0,1,2,64,84,1,2,2,13,125,45,410,2,2,414,186,600
6133,3,85,1,0,6,56,60,7,5,2,11,120,44,400,5,0,405,195,600
6134,0,76,0,1,2,50,57,3,3,2,10,126,59,389,4,1,394,206,600
6135,2,77,2,2,1,60,76,3,4,0,17,108,49,401,0,0,401,199,600
6136,2,96,1,1,1,60,58,2,3,3,19,108,41,395,6,0,401,199,600
6137,2,72,2,1,1,56,68,11,1,2,12,131,45,404,1,1,406,194,600
6138,3,91,2,0,3,41,81,3,3,0,16,111,47,401,2,0,403,197,600
6139,0,85,2,0,6,45,73,4,12,3,14,117,63,424,4,0,428,172,600
6140,1,93,1,0,1,42,63,6,2,2,9,125,56,401,5,1,407,193,600
6141,1,95,1,0,2,41,72,2,7,3,17,124,45,410,4,2,416,184,600
6142,1,88,3,1,3,42,75,1,3,4,11,122,27,381,2,2,385,215,600
6143,1,63,0,1,0,42,63,9,2,1,14,123,55,374,1,1,376,224,600
6144,2,84,1,3,5,57,67,3,2,1,13,104,39,381,2,1,384,216,600
6145,1,86,0,1,2,48,79,5,5,2,17,126,43,415,1,0,416,184,600
6146,2,74,1,1,5,52,52,5,6,1,17,138,45,399,8,0,407,193,600
6147,2,90,2,0,3,52,66,2,2,1,11,109,66,406,2,1,409,191,600
6148,3,80,1,2,2,58,55,3,1,3,13,128,63,412,5,1,418,182,600
6149,0,72,2,2,0,43,53,0,3,2,16,113,35,341,5,2,348,202,550
6150,2,72,0,0,0,49,57,3,0,1,15,107,32,338,3,0,341,209,550
6151,1,73,1,0,2,54,54,3,2,4,13,112,49,368,0,0,368,182,550
6152,2,67,1,1,1,42,59,4,4,1,13,107,32,334,4,0,338,212,550
6153,1,90,1,1,4,47,57,1,0,2,16,112,40,372,1,0,373,177,550
6154,1,58,1,0,1,41,58,2,2,4,7,120,38,333,5,0,338,181,519
6155,1,43,2,0,3,67,75,6,2,0,16,126,25,366,4,0,370,251,621
6156,1,78,3,1,2,48,56,0,4,1,15,137,43,389,8,0,397,203,600
6157,2,98,4,2,3,45,65,3,1,2,17,136,40,418,3,0,421,179,600
6158,1,69,5,1,2,48,67,3,2,1,19,127,29,374,3,0,377,173,550
6159,1,87,1,0,5,36,49,6,4,3,30,102,44,368,3,0,371,179,550
6160,2,54,2,1,0,48,76,3,4,3,13,111,49,366,4,2,372,178,550
6161,1,79,4,0,7,55,47,8,2,2,19,114,39,377,5,0,382,154,536
6162,4,23,1,0,1,30,29,4,0,2,4,116,6,220,3,1,224,146,370
6163,0,23,2,0,0,23,49,1,1,0,4,110,18,231,1,0,232,138,370
6164,2,28,0,0,0,21,27,3,0,1,9,108,10,209,1,0,210,119,329
6165,1,17,1,0,1,18,25,0,0,1,8,99,20,191,4,0,195,134,329
6166,0,0,0,1,1,5,18,0,1,0,2,3,3,34,0,0,34,4,38
6167,1,55,4,2,5,43,47,7,0,3,9,168,24,368,4,2,374,226,600
6168,1,57,2,0,0,49,46,5,1,2,11,181,19,374,2,0,376,224,600
6169,2,46,1,1,0,44,44,4,0,3,16,167,23,351,4,3,358,242,600
6170,1,52,1,1,3,52,40,5,2,3,15,143,36,354,2,0,356,244,600
6171,2,41,4,1,1,39,50,5,1,2,10,142,28,326,5,0,331,219,550
6172,2,47,6,0,0,31,36,3,0,2,11,156,27,321,3,0,324,204,528
6173,3,64,1,0,2,48,58,6,6,2,16,171,44,421,6,0,427,173,600
6174,1,74,0,0,5,57,55,9,1,4,12,142,37,397,3,0,400,200,600
6175,4,51,3,2,2,51,57,8,4,2,7,139,25,355,8,1,364,186,550
6176,2,66,2,0,3,54,46,6,1,1,24,132,29,366,3,0,369,181,550
6177,1,45,1,2,0,48,47,5,1,0,13,140,43,346,3,0,349,201,550
6178,2,79,0,3,5,51,44,8,0,0,18,138,36,384,6,5,395,155,550
6179,1,45,0,1,1,43,46,6,3,2,16,141,39,344,3,0,347,198,545
6180,2,51,0,3,12,69,58,8,1,6,22,71,39,342,4,3,349,180,529
6181,2,59,1,0,15,39,72,11,0,5,26,71,37,338,2,1,341,187,528
6182,0,39,1,1,2,45,52,11,2,3,9,104,38,307,4,1,312,138,450
6183,1,42,3,1,2,46,51,13,1,2,11,88,19,280,6,0,286,114,400
6184,2,51,1,2,2,26,50,16,0,1,16,108,24,299,8,0,307,134,441
6185,1,59,0,1,1,25,78,3,3,1,17,115,48,352,3,0,355,100,455
6186,4,25,6,0,5,29,44,7,0,2,10,161,13,306,16,1,323,287,610
6187,1,25,2,0,1,45,32,6,2,3,6,209,19,351,9,2,362,244,606
6188,6,33,1,1,2,33,43,4,2,2,5,137,33,302,9,2,313,187,500
6189,10,29,2,1,6,36,39,1,0,1,6,77,16,224,23,1,248,202,450
6190,6,30,1,0,6,37,49,3,0,1,9,123,15,280,9,1,290,167,457
6191,2,46,3,2,2,46,71,4,1,3,11,151,23,365,4,1,370,230,600
6192,3,40,3,3,1,52,67,7,0,3,10,173,39,401,7,3,411,189,600
6193,1,45,3,0,1,66,50,9,0,2,4,146,34,361,4,0,365,235,600
6194,4,43,3,1,2,38,54,8,4,2,14,181,27,381,6,2,389,211,600
6195,4,46,7,0,2,49,58,5,2,1,12,145,51,382,7,4,393,207,600
6196,1,39,3,0,2,46,49,8,0,0,16,167,27,358,9,2,369,231,600
6197,5,44,4,2,2,75,40,5,1,1,9,179,35,402,3,2,407,193,600
6198,3,46,4,3,2,42,59,10,1,1,9,157,30,367,5,0,372,188,560
6199,2,47,1,0,2,66,52,9,1,3,11,123,38,355,5,1,361,199,560
6200,4,20,1,1,0,17,71,4,0,7,3,114,22,264,6,3,273,277,550
6201,6,16,0,1,1,24,89,8,1,2,6,103,17,274,5,2,281,269,550
6202,8,27,2,1,1,18,94,6,4,4,2,130,16,313,14,4,331,236,567
6203,2,41,3,5,2,54,47,5,4,1,12,168,14,358,3,0,361,189,550
6204,5,43,3,3,3,41,47,6,2,3,3,167,28,354,5,1,360,165,525
6205,2,39,1,2,0,28,47,7,0,3,10,98,15,252,1,1,254,246,500
6206,2,42,2,0,4,24,51,5,1,3,6,105,8,253,8,2,263,257,520
6207,2,26,1,1,3,30,58,11,1,0,8,106,10,257,4,0,261,259,520
6208,3,13,0,1,0,25,47,2,1,3,11,133,16,255,2,4,261,179,440
6209,1,29,0,0,1,25,44,3,2,2,12,119,11,249,5,0,254,186,440
6210,4,15,1,0,0,23,44,6,1,2,10,121,8,235,6,2,243,187,430
6211,7,11,3,1,0,22,69,5,3,4,8,125,8,266,12,2,280,170,450
6212,2,19,8,2,1,21,58,5,2,7,11,109,12,257,5,0,262,173,435
6213,2,44,2,0,4,41,46,25,1,2,15,57,34,273,9,1,283,149,432
6214,5,19,2,1,3,33,48,7,3,0,8,134,13,276,8,0,284,214,498
6215,10,21,0,1,3,32,31,4,1,5,10,78,5,201,1,5,207,100,307
6216,5,29,1,2,5,32,30,7,1,2,9,115,9,247,7,2,256,244,500
6217,1,31,2,0,2,28,47,10,1,3,8,89,6,228,9,0,237,263,500
6218,0,43,0,0,1,36,49,6,2,0,12,117,10,276,6,0,282,202,484
6219,3,4,0,0,0,12,19,0,0,0,0,39,11,88,3,1,92,39,131
6220,7,8,1,0,2,11,37,4,2,2,6,46,5,131,1,1,133,106,239
6221,2,16,1,0,1,18,31,2,0,0,8,101,25,205,3,0,208,122,330
6222,5,15,2,1,0,13,43,0,1,0,6,99,17,202,2,1,205,125,330
6223,1,3,2,2,0,10,26,4,1,0,3,54,18,124,2,0,126,85,211
6224,4,50,7,5,1,47,43,9,1,4,4,145,33,353,4,1,358,242,600
6225,1,48,0,2,1,48,33,6,1,2,7,153,24,326,5,1,332,268,600
6226,5,40,2,2,2,34,52,9,1,2,14,122,26,311,7,0,318,282,600
6227,7,37,4,1,3,44,48,9,4,2,12,140,39,350,7,1,358,242,600
6228,3,31,1,4,2,41,39,2,1,3,9,152,21,309,5,4,318,232,550
6229,3,43,4,2,0,39,40,6,3,2,11,121,20,294,7,0,301,249,550
6230,2,29,1,4,3,39,52,5,1,2,12,126,24,300,6,1,307,235,542
6231,1,6,2,4,1,15,78,0,0,1,7,79,10,204,6,0,210,210,420
6232,1,17,0,6,1,16,89,1,1,3,1,83,7,226,4,3,233,187,420
6233,1,38,2,1,3,31,34,12,0,1,6,87,11,227,4,0,231,193,424
6234,2,46,1,1,1,31,58,7,0,5,7,145,6,310,4,1,315,185,500
6235,3,36,4,1,1,30,54,7,2,5,5,124,11,283,10,1,294,206,500
6236,4,26,2,0,3,41,58,6,0,2,8,125,15,290,4,0,294,206,500
6237,1,28,0,0,2,43,60,7,1,3,8,114,16,283,6,3,292,208,500
6238,4,31,1,0,3,48,78,5,1,2,8,110,10,301,5,1,307,190,497
6239,0,5,0,0,0,1,28,1,1,2,6,42,8,94,1,1,96,176,272
6240,2,4,2,0,0,1,23,2,1,0,1,35,2,73,5,1,79,192,271
6241,0,1,2,0,0,14,29,1,1,0,0,36,4,88,0,0,88,56,144
6242,3,13,2,2,2,23,90,1,0,3,6,132,22,299,6,0,305,222,527
6243,5,16,4,2,5,30,90,3,0,3,4,112,24,298,9,2,309,218,527
6244,2,16,1,0,0,14,89,4,1,4,4,136,20,291,11,5,307,220,527
6245,0,6,2,1,1,3,33,1,0,0,1,92,7,147,3,0,150,272,422
6246,2,1,0,0,1,1,1,0,0,0,2,15,1,24,1,1,26,16,42
6247,4,50,1,1,5,41,60,2,2,1,5,149,28,349,7,0,356,244,600
6248,2,59,0,3,3,42,50,4,1,0,13,122,20,319,2,0,321,279,600
6249,1,48,2,0,1,47,51,7,0,2,14,125,29,327,4,1,332,268,600
6250,5,49,2,2,2,47,52,12,2,1,8,133,33,348,5,0,353,247,600
6251,4,36,3,2,3,46,47,3,1,2,5,151,17,320,2,0,322,278,600
6252,8,59,2,3,3,38,49,4,3,3,11,161,22,366,7,0,373,227,600
6253,3,35,1,1,3,38,49,10,2,4,15,141,32,334,2,2,338,262,600
6254,2,53,2,1,4,37,44,5,2,1,9,145,22,327,9,2,338,262,600
6255,1,45,2,7,0,35,46,5,2,4,13,141,31,332,3,2,337,263,600
6256,3,38,2,1,3,48,53,2,0,3,6,132,29,320,4,0,324,276,600
6257,4,41,4,2,1,51,48,4,0,3,15,132,25,330,4,1,335,265,600
6258,1,46,1,1,1,34,45,10,0,3,11,141,24,318,9,0,327,223,550
6259,3,33,1,2,1,46,32,4,2,0,13,129,25,291,1,0,292,258,550
6260,1,34,2,1,0,39,47,1,3,3,15,135,26,307,2,1,310,240,550
6261,2,44,2,1,1,39,37,2,2,0,10,122,23,285,3,2,290,250,540
6262,0,10,1,2,1,31,41,12,0,4,9,104,17,232,4,0,236,254,490
6263,4,19,0,0,0,35,50,7,1,3,5,114,20,258,5,2,265,225,490
6264,4,27,0,1,1,30,46,2,0,0,6,94,33,244,11,0,255,235,490
6265,3,38,2,0,0,30,56,6,1,1,14,178,24,353,8,0,361,239,600
6266,1,38,4,5,1,55,51,1,1,1,11,149,26,344,7,0,351,199,550
6267,4,23,1,2,2,36,60,2,0,2,13,142,14,301,5,0,306,244,550
6268,0,33,2,0,0,44,45,2,2,0,10,133,8,279,5,0,284,266,550
6269,1,27,2,2,1,38,54,10,0,1,8,148,18,310,4,1,315,235,550
6270,1,36,0,1,4,42,60,3,0,4,9,122,9,291,2,0,293,236,529
6271,2,21,2,0,1,52,63,4,0,7,8,130,17,307,11,2,320,180,500
6272,3,13,3,0,1,45,71,4,2,7,8,133,24,314,5,4,323,177,500
6273,5,24,0,0,6,50,58,3,0,0,4,129,17,296,7,1,304,201,505
6274,0,45,3,3,0,25,73,11,2,1,5,87,13,268,10,2,280,135,415
6275,0,15,1,3,2,18,73,4,1,0,5,108,9,239,11,2,252,160,412
6276,1,27,2,0,3,35,81,8,1,1,5,89,26,279,16,0,295,240,535
6277,4,22,1,0,7,38,90,8,0,7,9,91,26,303,5,2,310,225,535
6278,1,37,5,1,2,40,96,11,0,4,8,86,33,324,11,2,337,198,535
6279,5,14,3,2,3,44,61,8,0,2,4,38,13,197,8,0,205,145,350
6280,1,43,4,3,5,43,45,4,1,2,6,157,27,341,9,3,353,247,600
6281,2,32,1,3,3,44,51,3,0,3,8,157,16,323,3,0,326,224,550
6282,4,46,3,1,1,39,44,4,1,1,5,151,16,316,3,2,321,227,548
6283,2,31,1,1,3,34,64,4,2,2,6,142,20,312,4,1,317,233,550
6284,4,47,6,1,0,40,39,6,0,0,7,124,32,306,8,1,315,235,550
6285,2,35,1,1,0,43,38,7,1,2,8,139,24,301,5,0,306,244,550
6286,1,41,1,4,1,40,49,5,1,0,5,121,24,293,2,3,298,232,530
6287,4,35,1,0,1,33,59,2,1,2,6,113,29,286,2,1,289,211,500
6288,4,28,2,1,3,33,58,2,3,1,6,127,22,290,8,2,300,200,500
6289,3,23,1,1,1,30,57,4,2,0,11,112,20,265,2,1,268,232,500
6290,2,19,3,0,3,38,61,1,0,1,4,122,17,271,4,0,275,225,500
6291,2,15,1,0,1,29,65,8,1,1,5,95,20,243,3,0,246,254,500
6292,4,26,2,1,4,44,64,5,2,3,5,137,15,312,5,1,318,236,554
6293,1,3,0,0,0,3,18,0,1,1,1,1,4,33,0,4,37,17,54
6294,1,13,0,2,0,9,12,0,0,0,2,53,75,167,3,0,170,240,410
6295,1,30,1,2,2,28,42,3,1,1,3,117,29,260,4,3,267,375,642
6296,4,15,1,0,7,22,83,6,0,3,2,97,18,258,4,0,262,269,531
6297,1,3,0,0,1,10,10,0,0,0,2,16,4,47,0,0,47,49,96
6298,2,44,0,0,2,51,71,6,3,1,21,142,36,379,11,2,392,158,550
6299,0,48,1,0,3,49,63,3,2,5,20,155,30,379,4,0,383,167,550
6300,1,63,0,0,2,62,52,1,3,2,15,138,39,378,2,1,381,169,550
6301,0,57,1,0,1,52,46,2,2,4,17,152,22,356,5,1,362,188,550
6302,1,55,1,1,2,50,44,1,2,5,17,147,28,354,5,0,359,191,550
6303,2,52,2,1,3,38,59,4,0,0,9,147,38,355,6,2,363,187,550
6304,1,46,3,2,8,42,80,7,2,4,10,140,36,381,5,0,386,169,555
6305,2,41,2,0,0,34,33,5,1,2,9,149,16,294,4,0,298,252,550
6306,2,42,2,1,1,48,28,1,0,1,9,153,14,302,2,0,304,246,550
6307,0,43,1,1,2,27,56,5,3,6,15,157,15,331,0,0,331,219,550
6308,1,31,6,0,1,38,36,2,3,4,7,134,21,284,3,1,288,212,500
6309,2,25,2,0,0,25,58,7,0,6,6,96,17,244,8,1,253,147,400
6310,4,28,0,0,3,36,47,2,0,6,11,104,29,270,3,0,273,127,400
6311,1,43,1,4,4,31,62,3,3,7,11,155,44,369,4,2,375,225,600
6312,3,46,2,0,2,33,59,5,3,5,19,146,32,355,4,0,359,241,600
6313,0,38,1,3,13,33,63,3,1,1,13,122,33,324,5,2,331,269,600
6314,3,50,2,1,11,32,66,4,0,4,14,130,34,351,3,0,354,246,600
6315,4,39,0,0,4,32,59,3,0,3,14,152,34,344,3,2,349,251,600
6316,0,44,2,2,8,25,63,1,3,1,17,127,26,319,4,0,323,227,550
6317,3,21,0,1,4,23,64,3,4,1,10,132,21,287,2,1,290,260,550
6318,1,29,2,1,6,22,60,5,2,2,12,142,37,321,1,0,322,228,550
6319,3,36,1,0,5,31,59,2,3,3,17,121,37,318,4,2,324,226,550
6320,3,47,1,0,1,24,60,2,5,1,15,118,26,303,2,1,306,244,550
6321,1,40,0,0,4,31,54,4,2,4,18,141,29,328,2,1,331,219,550
6322,1,39,0,1,8,26,65,5,1,5,20,132,34,337,4,3,344,206,550
6323,0,36,0,0,5,27,74,3,2,3,15,138,22,325,3,1,329,221,550
6324,2,35,1,0,5,27,62,6,0,6,27,129,27,327,4,0,331,235,566
6325,3,20,0,0,6,15,43,4,0,3,12,189,37,332,10,2,344,260,604
6326,1,31,1,2,11,18,53,8,0,7,8,132,18,290,6,1,297,306,603
6327,4,26,0,1,5,9,27,2,0,2,9,109,10,204,2,0,206,232,438
6328,4,59,0,1,2,16,40,2,3,5,34,39,43,248,7,1,256,149,405
6329,2,53,0,0,1,13,51,1,3,1,21,65,21,232,7,2,241,163,404
6330,0,22,3,0,3,12,29,0,2,3,8,129,23,234,4,1,239,108,347
6331,0,29,0,0,1,14,25,2,1,5,12,116,20,225,3,1,229,117,346
6332,2,11,1,0,3,22,70,4,0,2,8,99,14,236,1,0,237,244,481
6333,1,10,1,1,2,18,64,2,0,3,9,92,10,213,10,0,223,258,481
6334,2,9,1,1,0,10,37,5,1,3,15,137,14,235,5,0,240,160,400
6335,0,10,0,0,1,9,37,3,0,0,7,160,13,240,5,0,245,157,402
6336,0,21,2,0,8,19,37,4,0,3,7,18,15,134,2,2,138,126,264
6337,1,17,4,0,12,35,43,6,0,2,12,110,10,252,5,2,259,216,475
6338,1,18,2,0,10,25,63,6,0,2,6,119,11,263,4,1,268,206,474
6339,1,15,1,0,4,4,46,1,0,3,6,38,12,131,3,0,134,75,209
6340,0,7,1,0,4,14,17,2,0,0,5,81,4,135,1,0,136,85,221
6341,2,3,0,0,0,6,10,2,1,0,1,26,3,54,0,0,54,86,140
6342,4,11,0,0,4,9,32,2,0,2,2,134,7,207,5,0,212,180,392
6343,4,11,0,0,1,7,40,3,0,0,6,127,8,207,2,2,211,180,391
6344,1,27,0,1,0,35,53,0,1,4,9,180,24,335,5,0,340,260,600
6345,2,35,0,1,2,24,58,2,2,2,12,164,23,327,5,2,334,266,600
6346,2,27,1,3,1,24,60,1,1,1,15,186,27,349,6,2,357,243,600
6347,0,32,1,1,4,24,40,3,2,3,12,193,28,343,5,3,351,249,600
6348,1,38,2,0,2,26,47,0,2,2,6,166,26,318,7,1,326,274,600
6349,0,21,3,1,2,22,69,3,1,0,13,185,25,345,9,3,357,243,600
6350,2,32,4,0,2,17,60,6,0,5,13,171,25,337,8,0,345,255,600
6351,2,29,0,0,2,29,56,2,0,1,10,176,25,332,5,1,338,262,600
6352,1,32,0,0,6,26,37,5,2,2,17,146,15,289,2,1,292,258,550
6353,1,32,1,1,2,20,52,5,0,1,10,163,20,308,8,1,317,233,550
6354,0,23,0,1,2,18,38,4,1,4,13,149,22,275,6,2,283,267,550
6355,2,22,2,0,2,18,46,3,0,7,9,147,20,278,7,0,285,265,550
6356,4,37,0,1,3,23,62,5,0,2,6,131,19,293,6,0,299,252,551
6357,0,6,2,0,0,12,50,6,1,0,8,56,41,182,2,4,188,162,350
6358,2,16,0,2,1,10,28,5,1,2,2,87,27,183,5,2,190,154,344
6359,2,13,2,0,2,33,86,3,3,4,11,134,20,313,6,2,321,252,573
6360,1,12,1,0,2,40,76,0,4,3,9,120,20,288,7,1,296,277,573
6361,0,12,3,1,1,21,95,3,0,2,7,133,21,299,5,1,305,268,573
6362,2,7,0,0,0,19,52,2,2,0,4,79,15,182,10,2,194,209,403
6363,1,12,0,0,2,9,57,0,2,2,2,88,11,186,4,0,190,200,390
6364,2,6,0,1,0,25,48,1,1,1,1,49,3,138,3,1,142,121,263
6365,1,18,1,3,1,9,133,4,0,2,6,141,9,328,4,0,332,259,591
6366,2,6,3,0,0,8,68,1,0,2,2,65,12,169,3,1,173,291,464
6367,0,11,2,2,1,12,59,5,0,1,6,103,9,211,4,2,217,244,461
6368,2,5,0,1,2,1,20,0,0,2,2,6,3,44,8,1,53,76,129
6369,3,15,5,1,1,27,56,0,1,3,11,174,38,335,6,2,343,181,524
6370,5,25,4,0,3,30,62,5,3,0,7,156,38,338,11,4,353,171,524
6371,1,24,0,0,1,7,47,4,0,1,6,39,19,149,2,0,151,66,217
6372,0,2,0,0,0,4,9,0,0,0,1,17,19,52,1,0,53,33,86
6373,0,3,2,0,2,2,20,1,0,0,3,14,11,58,0,1,59,21,80
6374,2,23,1,1,1,17,53,4,1,6,6,123,21,259,3,1,263,234,497
6375,2,16,2,2,0,16,64,1,1,1,9,93,16,223,2,3,228,130,358
6376,1,17,2,1,5,10,66,2,1,0,17,89,19,230,4,1,235,122,357
6377,3,36,1,0,11,16,52,6,1,2,13,112,30,283,1,1,285,154,439
6378,2,29,2,1,1,29,52,5,0,1,16,102,19,259,1,3,263,176,439
6379,1,21,1,0,4,24,53,5,2,5,14,159,24,313,7,0,320,230,550
6380,0,29,0,1,4,42,52,7,2,2,20,136,18,313,5,1,319,231,550
6381,2,24,1,1,1,23,55,7,1,8,15,125,23,286,7,2,295,255,550
6382,1,28,2,1,2,27,63,12,0,2,14,151,28,331,8,0,339,211,550
6383,5,26,2,0,0,28,49,3,2,3,17,113,36,284,6,4,294,256,550
6384,2,23,2,0,3,18,49,7,3,4,15,144,31,301,14,1,316,234,550
6385,3,21,2,1,4,35,45,8,4,3,13,142,21,302,2,1,305,205,510
6386,1,2,1,0,4,0,20,5,0,0,6,78,4,121,2,1,124,81,205
6387,3,18,0,1,7,25,46,7,3,2,4,156,5,277,6,3,286,232,518
6388,0,2,0,0,0,4,9,4,1,0,8,14,5,47,0,0,47,42,89
6389,2,53,1,0,4,27,62,4,1,1,24,128,35,342,6,2,350,160,510
6390,1,47,4,0,1,27,89,8,1,2,15,109,45,349,5,0,354,156,510
6391,1,25,3,0,0,25,86,3,0,1,16,147,30,337,6,3,346,171,517
6392,2,18,2,0,3,14,45,6,0,1,11,142,43,287,7,2,296,204,500
6393,3,19,0,3,4,19,60,3,0,2,10,137,44,304,2,4,310,190,500
6394,0,20,1,1,1,21,35,4,1,3,19,140,35,281,4,3,288,212,500
6395,3,15,2,0,3,22,26,3,0,2,16,130,38,260,4,1,265,163,428
6396,2,12,1,3,4,21,51,1,0,0,22,160,27,304,6,0,310,157,467
6397,0,12,0,2,1,15,41,3,0,4,24,84,41,227,6,5,238,211,449
6398,0,34,0,1,5,25,59,4,4,1,43,111,29,316,3,0,319,291,610
6399,2,31,0,1,6,29,23,1,4,3,51,117,30,298,10,1,309,301,610
6400,0,33,4,2,1,20,44,4,2,5,49,124,27,315,4,1,320,290,610
6401,1,28,1,0,7,29,51,0,0,1,73,109,24,324,4,1,329,281,610
6402,0,27,1,0,5,31,36,7,0,1,48,100,36,292,2,0,294,312,606
6403,0,17,2,0,16,11,32,1,2,3,14,130,36,264,1,1,266,236,502
6404,3,14,1,0,7,4,38,1,0,2,10,129,38,247,10,5,262,240,502
6405,0,22,1,2,11,12,38,0,0,4,17,104,28,239,2,3,244,258,502
6406,1,29,1,0,4,8,31,2,1,0,9,137,36,259,7,1,267,234,501
6407,0,17,0,0,2,10,43,1,0,1,25,101,11,211,1,3,215,98,313
6408,0,0,0,0,0,0,4,0,0,0,0,2,4,10,1,0,11,5,16
6409,1,18,1,0,3,18,28,0,2,1,12,81,20,185,0,4,189,276,465
6410,1,11,5,1,2,13,39,3,1,1,26,75,17,195,4,2,201,264,465
6411,1,22,8,0,2,8,30,1,0,1,24,59,20,176,1,1,178,287,465
6412,1,14,2,4,5,17,23,2,2,2,48,91,39,250,9,1,260,241,501
6413,1,13,1,0,9,27,35,2,0,3,55,97,24,267,6,3,276,225,501
6414,0,18,1,1,5,34,33,4,1,5,54,70,37,263,8,4,275,226,501
6415,0,6,0,0,1,5,25,2,0,0,9,62,11,121,2,1,124,80,204
6416,1,21,2,0,2,15,50,2,0,2,55,99,34,283,7,0,290,312,602
6417,1,5,6,1,0,33,29,4,3,2,27,98,30,239,5,2,246,231,477
6418,3,25,2,0,1,24,49,0,0,6,36,95,19,260,3,0,263,213,476
6419,0,41,2,0,1,28,61,2,0,3,20,72,32,262,5,3,270,255,525
6420,0,38,3,0,5,30,63,5,0,1,22,56,22,245,8,6,259,266,525
6421,1,40,2,1,9,20,14,1,2,2,22,76,28,218,4,6,228,291,519
6422,0,39,0,0,7,16,32,4,0,2,21,84,36,241,10,4,255,264,519
6423,0,40,1,1,11,18,35,1,1,1,12,86,25,232,5,2,239,280,519
6424,0,27,0,2,4,29,22,0,1,0,14,43,23,165,2,2,169,146,315
6425,1,22,4,0,2,31,30,0,2,2,19,112,63,288,3,1,292,227,519
6426,0,15,3,1,3,17,22,2,1,0,12,123,49,248,7,4,259,259,518
6427,0,19,2,0,0,27,34,1,0,2,15,126,57,283,2,1,286,231,517
6428,0,32,3,0,2,18,26,3,0,0,16,142,56,298,1,0,299,218,517
6429,0,11,0,0,0,6,25,1,2,1,29,10,8,93,3,0,96,39,135
6430,2,31,1,2,4,26,66,2,4,2,38,109,41,328,7,6,341,250,591
6431,0,7,0,1,19,12,56,3,1,1,31,66,42,239,9,4,252,226,478
6432,1,12,0,0,12,6,72,2,0,1,37,57,32,232,3,1,236,242,478
6433,0,10,0,1,26,11,62,1,0,5,29,59,28,232,7,3,242,236,478
6434,0,23,0,0,19,7,60,0,0,1,21,70,29,230,5,3,238,239,477
6435,0,4,1,0,11,6,23,2,0,5,10,49,97,208,2,2,212,198,410
6436,2,4,0,0,6,10,25,2,1,1,10,21,20,102,3,2,107,221,328
6437,0,4,2,0,7,6,27,0,0,3,5,25,36,115,5,2,122,206,328
6438,1,10,4,0,6,3,16,0,0,2,87,81,45,255,12,4,271,244,515
6439,2,16,2,2,17,4,11,0,0,0,61,65,48,228,8,7,243,272,515
6440,0,2,0,0,0,0,37,0,0,1,0,2,8,50,1,0,51,151,202
6441,0,8,1,0,1,5,9,1,0,8,19,10,43,105,8,1,114,111,225
6442,3,0,0,0,1,0,5,1,1,0,0,43,1,55,2,4,61,168,229
6443,4,24,1,0,1,18,55,2,0,0,7,158,24,294,6,1,301,233,534
6444,5,27,1,1,0,24,55,1,0,1,10,159,17,301,5,2,308,226,534
6445,3,17,0,1,3,27,53,4,1,3,11,118,20,261,10,2,273,261,534
6446,3,10,0,0,1,14,58,4,2,2,12,166,16,288,5,1,294,240,534
6447,1,6,0,0,1,23,43,2,0,0,4,113,21,214,4,4,222,304,526
6448,1,14,2,0,0,12,60,2,0,1,35,97,39,263,3,6,272,192,464
6449,3,10,0,1,1,8,48,2,0,2,1,91,22,189,5,2,196,179,375
6450,2,14,0,0,1,13,29,3,0,1,7,149,22,241,5,1,247,153,400
6451,2,4,2,2,0,17,31,1,0,2,9,171,28,269,4,0,273,217,490
6452,0,6,0,0,0,2,53,1,0,0,1,50,12,125,2,1,128,151,279
6453,0,6,0,1,5,2,19,3,1,4,4,44,5,94,0,0,94,169,263
6454,0,10,3,1,2,9,34,1,0,0,4,80,11,155,1,1,157,105,262
6455,0,18,1,1,4,18,51,2,0,0,18,159,40,312,3,2,317,283,600
6456,2,26,2,0,0,28,73,1,0,5,26,127,39,329,7,1,337,263,600
6457,0,25,2,2,1,30,39,0,1,0,17,143,41,301,6,0,307,293,600
6458,0,29,3,2,3,29,50,6,1,3,16,164,27,333,5,0,338,262,600
6459,0,23,1,0,0,19,64,4,1,3,20,144,27,306,6,1,313,287,600
6460,3,31,5,3,5,20,58,1,2,3,19,134,31,315,8,1,324,276,600
6461,0,25,2,1,4,11,49,3,0,1,6,155,24,281,13,0,294,306,600
6462,0,17,3,3,3,26,44,3,1,1,12,163,26,302,7,1,310,290,600
6463,1,26,5,0,5,18,62,3,0,2,16,157,31,326,4,4,334,266,600
6464,1,26,2,1,7,25,50,1,0,2,11,166,28,320,7,1,328,272,600
6465,0,38,2,0,5,21,50,4,1,0,10,152,35,318,3,1,322,278,600
6466,1,26,4,1,1,14,67,2,0,1,13,159,37,326,9,2,337,254,591
6467,0,7,1,1,7,12,35,1,0,1,5,73,30,173,0,1,174,203,377
6468,0,9,1,0,4,11,46,1,0,2,2,88,27,191,4,0,195,181,376
6469,2,15,3,2,2,8,63,1,2,1,8,142,20,269,3,4,276,190,466
6470,1,14,2,0,0,17,53,2,2,0,3,142,17,253,5,2,260,205,465
6471,0,12,11,0,3,19,87,1,0,0,5,140,37,315,7,1,323,322,645
6472,0,10,0,1,3,14,49,4,0,3,3,93,30,210,6,1,217,194,411
6473,1,26,0,0,4,10,43,0,2,1,4,84,49,224,3,3,230,180,410
6474,5,9,1,0,3,11,48,2,1,1,7,56,10,154,3,0,157,160,317
6475,1,17,1,1,2,15,32,2,1,2,7,97,26,204,3,2,209,140,349
6476,2,14,4,0,1,21,46,5,1,2,9,155,15,275,5,0,280,165,445
6477,1,8,2,1,1,17,32,3,0,0,8,171,11,255,8,5,268,176,444
6478,1,13,0,0,2,12,36,8,0,2,7,163,11,255,9,0,264,180,444
6479,3,16,0,0,3,22,56,2,3,3,5,157,27,297,6,2,305,240,545
6480,3,20,1,1,2,15,55,2,1,0,2,152,33,287,12,1,300,243,543
6481,0,13,0,1,0,24,40,3,1,3,12,164,20,281,7,2,290,233,523
6482,2,10,3,1,1,18,59,5,0,1,9,143,18,270,3,1,274,249,523
6483,0,16,0,0,1,34,55,5,0,2,15,133,25,286,5,1,292,230,522
6484,0,11,3,1,0,17,82,9,2,3,9,127,17,281,5,4,290,232,522
6485,2,11,1,4,2,20,61,4,1,2,6,154,17,285,6,1,292,230,522
6486,0,22,1,0,0,26,73,6,0,1,8,186,40,363,3,2,368,258,626
6487,4,37,2,1,1,30,39,5,1,1,15,150,23,309,2,0,311,289,600
6488,3,38,4,2,5,36,39,6,1,2,17,127,36,316,7,0,323,277,600
6489,5,39,2,1,0,32,48,9,1,2,13,135,29,316,4,1,321,279,600
6490,2,54,2,2,3,42,44,3,0,2,19,124,33,330,2,0,332,268,600
6491,4,54,2,0,3,34,55,6,1,4,9,134,32,338,7,1,346,254,600
6492,8,47,4,1,2,29,63,7,0,3,10,130,22,326,5,0,331,269,600
6493,2,41,1,0,2,30,55,1,0,3,11,150,31,327,8,0,335,265,600
6494,2,42,0,0,5,39,71,1,1,4,15,132,20,332,5,1,338,262,600
6495,3,53,1,0,2,51,54,4,2,1,12,123,16,322,7,0,329,271,600
6496,4,57,2,3,6,37,45,2,1,1,10,117,31,316,5,1,322,278,600
6497,2,44,3,0,3,26,50,4,0,4,16,153,16,321,6,2,329,271,600
6498,4,36,1,0,3,35,51,5,0,0,13,119,27,294,9,1,304,296,600
6499,3,52,1,1,3,42,44,4,2,3,14,133,22,324,5,0,329,271,600
6500,0,45,1,0,3,39,58,7,0,2,13,106,33,307,6,0,313,287,600
6501,1,39,2,0,3,45,45,3,1,0,16,139,21,315,6,0,321,279,600
6502,5,38,1,0,3,43,53,5,1,4,25,113,28,319,5,0,324,285,609
6503,0,32,1,2,1,30,35,5,1,1,15,74,27,224,2,2,228,149,377
6504,1,31,0,0,4,20,34,5,4,0,12,66,31,208,1,1,210,167,377
6505,0,19,0,0,1,22,51,2,0,5,7,112,18,237,5,1,243,157,400
6506,5,11,4,0,1,25,51,3,0,2,16,95,17,230,5,2,237,189,426
6507,4,37,0,0,2,29,48,7,2,7,25,168,30,359,8,0,367,152,519
6508,4,33,3,0,3,36,56,10,2,4,8,101,29,289,1,2,292,208,500
6509,2,26,1,0,5,39,51,1,1,5,13,130,27,301,1,0,302,196,498
6510,0,2,2,0,0,2,17,0,0,2,3,60,8,96,2,1,99,54,153
6511,0,1,1,0,0,1,10,0,0,0,0,0,0,13,0,1,14,4,18
6512,1,47,3,1,2,22,76,2,3,2,10,135,13,317,4,1,322,122,444
6513,1,45,4,0,1,12,56,1,2,3,8,130,12,275,7,1,283,161,444
6514,2,27,5,1,3,14,53,5,2,1,15,175,33,336,7,1,344,156,500
6515,1,39,0,3,1,26,48,13,0,2,18,126,21,298,11,1,310,190,500
6516,2,30,5,1,3,20,54,2,3,2,13,144,28,307,7,1,315,185,500
6517,2,47,5,1,3,18,42,0,0,5,2,119,32,276,2,6,284,216,500
6518,3,29,4,0,2,9,37,4,2,4,8,140,22,264,6,2,272,197,469
6519,0,0,0,0,0,0,13,2,1,1,0,5,1,23,0,0,23,26,49
6520,0,25,1,4,0,14,38,6,1,2,8,213,10,322,2,0,324,176,500
6521,3,20,0,0,1,16,23,3,1,2,5,225,13,312,11,2,325,175,500
6522,1,28,3,0,0,10,28,3,0,3,1,230,11,318,10,3,331,175,506
6523,0,20,5,0,4,33,65,3,5,2,20,171,23,351,3,1,355,213,568
6524,3,39,4,2,1,26,64,9,0,1,4,162,18,333,5,2,340,260,600
6525,0,24,4,0,3,29,64,5,1,3,20,169,25,347,15,1,363,237,600
6526,2,31,6,0,3,29,73,4,1,6,7,166,20,348,20,3,371,229,600
6527,1,32,6,1,5,26,67,6,0,3,14,146,26,333,15,3,351,249,600
6528,2,27,7,1,1,32,64,7,2,1,11,172,15,342,11,1,354,246,600
6529,1,25,2,0,4,29,72,8,4,7,6,189,25,372,4,1,377,223,600
6530,2,34,9,1,1,22,78,7,3,4,7,180,18,366,11,2,379,221,600
6531,2,27,7,1,2,28,58,3,1,0,8,171,19,327,7,0,334,242,576
6532,2,8,7,3,3,17,110,2,2,0,5,147,8,314,10,0,324,212,536
6533,2,12,5,0,5,26,116,2,3,1,10,146,14,342,9,2,353,183,536
6534,0,13,5,1,2,7,128,0,1,6,8,216,9,396,17,1,414,219,633
6535,4,15,10,0,8,26,99,2,0,0,10,145,26,345,4,2,351,224,575
6536,0,21,5,0,7,24,67,2,0,1,19,162,30,338,4,0,342,233,575
6537,0,33,3,0,4,17,64,2,1,1,11,169,24,329,9,3,341,209,550
6538,3,10,0,2,0,7,92,3,0,4,3,70,14,208,3,1,212,128,340
6539,1,2,0,0,3,14,93,1,1,6,6,54,6,187,8,3,198,143,341
6540,1,26,4,1,5,16,74,1,2,1,9,145,9,294,5,0,299,251,550
6541,1,31,4,1,9,25,68,5,2,0,7,115,19,287,10,3,300,250,550
6542,3,27,0,0,1,25,74,2,1,1,5,162,23,324,6,2,332,209,541
6543,0,109,0,0,6,5,9,0,3,0,0,2,29,163,0,0,163,318,481
6544,0,44,0,0,8,4,7,1,1,0,0,3,12,80,2,0,82,144,226
6545,0,22,0,0,0,3,3,0,0,0,0,1,9,38,0,0,38,64,102
6546,0,25,0,0,1,2,11,0,0,0,1,0,11,51,0,0,51,96,147
6547,0,1,0,0,0,0,3,0,0,0,0,0,0,4,0,0,4,5,9
6548,0,7,0,0,3,1,3,1,0,0,0,3,3,21,0,0,21,70,91
6549,0,29,0,0,0,0,5,2,1,1,2,4,10,54,0,0,54,400,454
6550,0,40,0,0,4,7,12,1,2,1,1,7,15,90,1,0,91,452,543
6551,0,52,1,1,2,1,21,0,0,0,0,4,26,108,0,0,108,124,232
6552,0,13,1,0,1,0,5,1,0,0,0,0,5,26,0,0,26,81,107
6554,0,22,0,0,1,5,26,0,0,0,1,2,15,72,0,0,72,280,352
6555,0,7,0,0,0,1,2,0,0,0,0,2,2,14,0,0,14,19,33
6556,1,11,0,0,2,3,1,1,1,3,0,1,0,24,1,0,25,18,43
6557,0,12,0,0,3,0,1,1,0,0,0,2,6,25,0,0,25,117,142
6558,0,22,0,0,0,5,9,0,1,0,1,13,13,64,0,0,64,736,800
6559,0,13,0,0,0,1,6,1,0,0,0,18,14,53,1,0,54,746,800
6560,0,23,0,0,0,4,9,0,0,0,4,7,9,56,0,0,56,644,700
6561,1,14,0,0,0,5,14,2,0,0,4,28,12,80,0,0,80,820,900
6562,0,21,0,0,1,5,9,0,1,1,0,23,16,77,1,0,78,867,945
6563,0,22,1,0,0,8,4,0,0,0,0,9,15,59,1,0,60,840,900
6564,0,18,1,0,0,4,11,1,2,0,3,4,11,55,0,0,55,845,900
6565,0,19,0,0,0,3,12,0,0,0,0,15,11,60,0,0,60,840,900
6566,0,16,0,0,0,3,7,0,0,1,2,10,15,54,0,0,54,792,846
6567,0,14,0,0,0,5,11,0,1,0,1,11,19,62,2,0,64,787,851
6568,0,11,0,0,0,10,16,0,0,0,1,11,14,63,1,0,64,786,850
6569,0,16,0,0,0,9,14,0,3,0,2,7,21,72,3,0,75,775,850
6570,1,14,0,0,0,8,19,0,0,0,1,10,17,70,1,0,71,787,858
6571,1,14,0,1,3,11,12,0,1,0,0,20,9,72,1,0,73,927,1000
6572,0,19,1,0,0,9,12,0,1,2,1,13,19,77,0,0,77,923,1000
6573,0,13,0,0,0,6,10,0,0,0,0,15,17,61,1,0,62,888,950
6574,1,23,0,0,0,3,7,1,0,0,0,7,14,56,0,1,57,893,950
6575,0,26,1,1,0,4,8,0,0,1,2,8,18,69,0,0,69,881,950
6576,0,17,1,0,1,3,17,0,1,0,1,17,8,66,3,0,69,881,950
6577,0,20,0,0,0,4,10,0,0,0,2,16,15,67,1,0,68,882,950
6578,0,23,1,0,1,6,10,0,0,0,1,18,16,76,0,0,76,874,950
6579,0,21,0,0,0,5,12,0,0,0,1,11,12,62,0,0,62,912,974
6580,0,38,0,0,2,3,11,0,1,0,2,11,34,102,1,0,103,797,900
6581,0,38,0,0,1,2,19,1,1,0,1,14,33,110,1,0,111,830,941
6582,0,64,1,0,2,1,15,1,1,0,0,10,30,125,0,0,125,646,771
6583,0,18,0,0,1,10,16,1,0,1,1,4,15,67,0,0,67,219,286
6584,0,105,0,1,4,3,26,1,1,0,0,11,50,202,5,0,207,583,790
6585,0,90,0,0,6,4,20,0,2,0,0,1,18,141,0,0,141,230,371
6586,1,37,0,0,5,16,33,0,2,0,1,25,40,160,1,1,162,272,434
6587,0,19,1,0,1,6,15,1,1,0,1,9,22,76,0,0,76,152,228
6588,0,2,0,0,0,2,4,0,0,0,0,0,5,13,1,0,14,76,90
6589,0,29,0,0,0,3,13,0,0,3,1,4,11,64,0,0,64,187,251
6590,0,14,0,0,1,2,0,0,0,0,0,2,7,26,0,1,27,52,79
6591,0,67,1,0,4,6,23,1,1,3,0,14,68,188,0,0,188,695,883
6592,0,1,1,0,0,1,9,1,0,1,0,3,9,26,1,0,27,40,67
6593,0,20,2,0,1,3,17,2,0,2,0,10,19,76,3,0,79,361,440
6594,0,75,0,0,3,3,8,2,0,0,0,1,17,109,0,0,109,116,225
6595,0,38,1,0,0,5,54,5,1,1,0,21,47,173,0,0,173,391,564
6596,0,9,0,0,0,5,3,0,0,0,0,6,3,26,0,0,26,143,169
6597,0,16,0,0,0,3,9,0,0,0,0,7,8,43,1,0,44,115,159
6598,0,53,0,1,3,1,31,0,1,0,0,2,28,120,1,0,121,174,295
6599,0,10,1,0,0,0,8,0,1,0,0,9,18,47,0,0,47,69,116
6600,0,9,0,0,0,2,3,0,0,0,0,0,0,14,0,0,14,25,39
6601,0,5,0,0,0,0,1,1,0,0,0,2,3,12,0,0,12,30,42
6602,0,41,0,0,4,1,21,0,0,0,0,7,20,94,0,0,94,204,298
6603,0,1,0,0,0,0,1,0,0,0,0,1,0,3,0,0,3,3,6
6604,0,8,0,0,0,2,0,0,0,0,0,2,2,14,0,0,14,6,20
6605,0,8,0,0,2,1,21,0,0,0,3,5,10,50,1,0,51,339,390
6606,0,0,0,0,0,0,2,0,0,0,0,0,0,2,0,0,2,7,9
6607,0,3,0,0,0,2,4,0,0,0,0,0,7,16,1,0,17,22,39
6608,0,6,0,0,0,0,0,0,0,0,0,0,2,8,0,0,8,31,39
6609,0,2,0,1,0,0,4,0,0,0,1,4,2,14,0,0,14,15,29
6610,0,28,0,0,3,3,4,1,0,0,0,4,7,50,0,0,50,73,123
6611,0,0,0,0,0,0,0,0,0,0,0,0,0,0,0,0,0,3,3
6612,0,1,0,0,0,0,0,0,0,0,0,0,0,1,0,0,1,1,2
